Ww, Hh, Hh, Hh, Mm^Xm, Mm^Xm, Mm^Xm, Mm^Xm, Mm^Xm, Mm^Xm, Mm^Xm, Ms^Xm, Ms^Xm, Mm^Xm, Mm^Xm, Mm^Xm, Mm^Xm, Gs, Mm^Xm, Mm^Xm, Mm, Mm, Mm, Mm, Mm, Gs, Gg, Rp, Ww, Gg, Mm, Gs, Mm, Md, Mm, Mm, Mm, Mm, Mm, Md, Hhd, Rd, Hh, Rd, Gs^Fds, Rd
Ww, Ww, Ww, Mm, Mm, Mm^Xm, Hh, Hh, Hh, Hh, Hh, Mm^Xm, Mm^Xm, Mm^Xm, Mm, Mm^Xm, Mm, Mm^Xm, Mm, Mm, Mm, Mm, Mm, Mm, Mm, Mm, Gg, Rp, Gg, Ww, Mm, Mm, Mm, Mm, Mm, Mm, Mm, Mm, Mm, Mm, Md, Md, Md, Hh, Re, Gg
Gg, Ww, Ww, Ww, Ww, Ww, Ww, Gs^Fms, Gs^Fms, Gs^Fms, Gs^Fms, Gs^Fms, Gs^Fms, Hh, Hh, Hh, Hh, Mm, Gs^Fms, Hh, Hh, Hh, Hh, Hh, Rp, Rp, Rp, Rp, Ww, Ww, Gll^Fdw, Hh, Hh, Mm, Hh, Mm, Mm, Mm, Hhd^Vhhr, Hh, Hh, Md, Re, Hh, Re, Mm
Hh, Gg, Gs^Fms, Ww, Ww, Ww, Ww, Ww, Ww, Ww, Ww, Gs^Fms, Gs^Fms, Gs^Fms, Gs^Fms, Gs^Fms, Gs^Fms, Gs^Fms, Rp, Rp, Rp, Rp, Rp, Rp, Gg, Gg, Gll^Fdw, Rp, Ww^Bw\, Gll^Fdw, Gd^Vo, Gll^Fdw, Hh, Mm, Mm, Mm, Hh, Hh, Gs, Gs^Fms, Re, Re, Gs^Fds, Re, Mm, Mm
Mm^Xm, Hh, Hh, Gs^Fms, Gs^Fms, Gg, Gs^Fms, Ww, Ww, Ww, Ww, Ww, Ww, Ww, Ww, Ww, Ww, Gg, Rp, Gg, Ww^Vm, Gg, Gg, Gg, Ww, Gs, Ww, Ww, Gll^Fdw, Rb, Rb, Gll^Fdw, Gll^Fdw, Hh, Gll^Fdw, Mm, Gd^Fetd, Hh, Gs, Gs, Rb, Hh, Hh, Hh, Mm, Hhd
Mm^Xm, Mm^Xm, Mm, Hh, Gs^Fms, Gs^Fms, Hh, Gs^Fms, Gs^Fms, Gs^Fms, Gs^Fms, Ww, Ww, Ww, Ww, Ww, Ww^Bw/, Ww^Bw/, Ww, Ww, Ww^Ewf, Ww, Ww, Ww, Ww, Ww, Ww, Gs, Gs, Gll^Fdw, Gll^Fdw, Rb, Gll^Fdw, Gll^Fdw, Gll^Fdw, Gll^Fdw, Gll^Fdw, Gd, Rb, Rb, Gd, Gs^Fms, Mm, Mm, Md, Rd
Mm, Mm^Xm, Mm, Hh, Hh, Gs^Fms, Gg, Hh, Gs^Fms, Gs^Fms, Gs^Fms, Gs^Fms, Gs^Vh, Gs^Fms, Rb, Rb, Gs^Fms, Ww, Ww, Ww, Gs, Ww, Ww, Ww, Ww, Ww, Ww, Ww, Gs, Gs, Gd^Vo, Rb, Rb, Hhd, 3 Ko, Gll^Fdw, Gll^Fdw, Gll^Fdw, Rb, Rd^Ecf, Gd, Mm, Mm, Mm, Md, Rd
Mm^Xm, Mm^Xm, Mm, Hh, Hh, Gs^Fms, Gs^Fms, Gs^Fms, Gs^Fms, Gs^Fms, Rb, Rb, Rb, Rb, Rb, Gs^Fms, Gs^Fms, Gs, Gs^Fms, Gs^Fms, Gs^Fms, Gs, Gs, Gs, Gs, Ww, Ww, Ww, Wwf, Ss, Ss, Sm^Edt, Rb, Co, Co, Co, Rb, Gll^Fdw, Rb, Gd^Fetd, Mm, Mm, Hh^Vhh, Hh, Gs^Fds, Gs^Fms
Mm^Xm, Mm^Xm, Hh, Mm, Hh, Gs^Fms, Gs^Fms, Gs^Fms, Rb, Rb, Hh, Gs^Fms, Gs^Fms, Gg, Gs^Fms, Rb, Rb, Gs^Efm, Gg, Gs^Fms, Gs^Fms, Gs, Gs^Fms, Gs^Fms, Gs^Fms, Ww, Wwf, Wwf, Wwf, Wwf, Wwg, Sm, Sm, Rb^Edt, Rb, Rb, Rb, Rb, Rb, Mm, Hh, Hh, Gs, Gg, Gg, Gs^Fms
Mm^Xm, Mm^Xm, Hh, Hh, Gs^Fms, Gs^Vc, Rb, Rb, Hh, Hh, Mm, Mm, Hh, Hh, Rb, Gg, Rb, Gg, Gs^Fms, Gg, Gg, Gg^Fet, Hh, Hh, Gs^Fms, Gs^Fms, Gg, Wwf, Gg, Ww, Ww, Wwg, Sm, Rb, Gll^Edb, Gll^Fdw, Rb, Rb, Rb, Rb, Rb, Gll, Rb, Rb, Rb, Rb
Mm^Xm, Hh, Hh, Gs^Fms, Gs^Fms, Rb, Gs^Fms, Gs^Fms, Hh, Mm, Mm, Hh, Hh, Rb, Gg^Fet, Rb, Gs^Fms, Gs^Fms, Gs^Fms, Rb, Gg, Gs^Fms, Gg, Mm, Gg, Gs, Gs, Gg, Wwf, Ww^Es, Ww, Ww, Gg^Em, Rb, Rb, Rb, Gll^Fdw, Gll^Fdw, Cud, Cud, Cud, Rb, Gg, Gg, Gg, Gg
Hh, Hh, Gs^Fms, Gs^Fms, Gs^Fms, Rb, Gs^Fms, Hh, Mm, Mm, Hh, Hh, Gs^Fms, Rb, Gs^Fms, Gs^Fms, Mm, Gs^Fds, Hh, Gs^Fds, Gs^Fds, Gg, Gg, Gg, Gs^Fms, Gs^Fds, Gg, Gs^Fms, Wwf, Ww, Wwf^Es, Gg, Rb, Rb, Gll^Es, Gll^Ecf, Gll^Fdw, Gll^Fdw, Gll^Edt, 4 Kud, Gll^Fdw, Gll^Edt, Gll^Fdw, Ss, Ss, Ss
Gs^Fms, Gs^Fms, Gs^Fms, Gs^Fms, Gg^Fet, Rb, Gs^Fms, Gs^Fms, Hh, Hh, Gs^Fms, Gs^Fms, Gs^Fms, Rb, Rb, Mm, Mm, Mm, Mm, Hh, Gs^Fds, Gs^Fds, Gg, Gs^Fms, Gs^Fds, Gs^Vh, Gg, Gg, Wwf^Es, Wwf, Ww^Bw/r, Wwf^Bw/, Wwf^Es, Gg, Gg, Gd^Fetd, Gll, Gll^Fdw, Gll, Gll^Fdw, Gll^Fdw, Gll^Fdw, Gs^Fms, Gs^Fds, Sm, Ss
Gs^Fms, Gs^Fms, Gs^Fms, Gs^Fms, Gg, Rb, Gs^Fms, Gs^Fms, Gs^Fms, Gs^Fms, Gg^Ve, Gs^Fms, Gs^Fms, Gs^Fms, Rb, Hh, Gg^Ve, Mm, Mm, Mm, Hh, Gs^Fds, Gs^Edb, Gs^Fms, Gg, Gg, Rb, Gs, Rb, Wwf^Bw/, Wwf^Es, Wwf, Ww^Es, Ww, Ww, Gg^Em, Ww^Vm, Gg, Gg, Gll, Gll, Gll, Gd^Vo, Gs^Fms, Ww, Ww
Gs^Fms, Gs^Fms, Gs^Fms, Gs^Fms, Rb, Rb, Rb, Gs^Fms, Rb, Gs^Fms, Gs^Fms, Gg, Rb, Gs^Fms, Gs^Fms, Rb, Rb, Gs^Fms, Gs^Fds, Hh, Gg, Gs, Gs^Fms, Gg, Rb, Rb, Gs^Fms, Rb, Gs^Fms, Gs, Gs^Fds, Ww, Ww^Ewf, Ww, Wwf, Wwf, Ww^Es, Ww, Ww, Gg, Gg^Em, Gg, Ww, Ww, Ww, Ww
Rb, Gs^Fms, Rb, Gs^Vl, Rb, Gg, Gs^Fms, Rb, Gs^Fms, Rb, Rb, Rb, Gs^Fms, Rb, Rb, Gs^Fms, Rb, Gs^Fms, Gs^Fms, Gs^Fds, Gs^Edb, Gs^Fds, Gg, Gs^Fms, Rb, Gs^Fms, Hh, Gs^Efm, Gs^Efm, Gg, Gs^Fms, Gs, Gs, Wwf, Wwf, Ww, Ww, Ww, Ww, Ww, Ww, Ww, Ww, Ww, Wo, Wo
Gs^Fms, Rb, Gs^Fms, Rb, Gs^Fms, Gs^Fms, Gs^Fms, Gs^Fms, Gs^Fds, Gs^Fms, Gs^Fms, Gs^Fms, Gg, Gs^Fms, Gg, Rb, Cv, Gg, Rb, Rb, Rb, Gs^Fms, Rb, Rb, Gs^Fms, Hh, Gg^Fet, Gg, Gg, Hh, Hh^Vhh, Gs, Hh, Gs^Efm, Gs, Ss, Ss, Ss, Ss, Ww, Ww, Ww, Ww, Wo, Wo, Wo
Gg, Gs^Fms, Gs^Fds, Gs^Fms, Gs^Fms, Gs^Fms, Hh, Gs^Fms, Gs^Fds, Gs^Fds, Gs^Fms, Hh, Hh, Gs^Fms, Gg, Cv, 2 Kv, Cv, Gg, Gs^Fms, Gs^Fms, Rb, Gs^Fds, Rb, Rb, Gs^Fms, Gs, Gg, Gs^Fms, Mm, Gg, Hh, Gs, Gs^Efm, Gs^Efm, Gs, Gs^Fds, Ss, Ss, Ss, Ss, Ww, Ww, Wo, Wo, Wo
Gs^Fds, Gs^Fms, Hh, Gs^Fms, Gs^Fms, Hh, Gs^Fms, Gg^Fet, Gs^Fds, Hh, Gs^Fms, Hh, Gs^Fds, Gs^Fds, Gg, Cv, Cv, Cv, Gg, Gg, Gs^Fds, Gg^Ve, Gs^Fds, Gs^Fms, Gg, Rb, Rb, Gs^Fms, Gs^Fms, Gs^Efm, Gs^Efm, Gs^Fms, Ce, Ce, Gs^Fms, Gs^Fms, Gs^Fms, Gs^Fms, Ss, Ss, Ss, Ww, Ww, Ww, Ww, Wo
Gs^Fms, Hh, Mm, Gs^Fms, Gs^Fms, Gs^Fms, Gs^Fms, Gs^Fms, Gs^Fds, Gs^Fms, Rb, Gs^Fds, Gs^Fms, Gs^Fds, Gs^Fms, Gs, Rb, Gg, Gs^Fms, Gs^Fms, Gs^Fms, Gs^Fms, Gs^Fms, Gs^Fms, Gs^Fms, Gs^Fms, Gs^Fms, Rb, Gg, Gs^Fms, Gs, Gg, Gs^Edb, Ke, Gg, Gs^Fms, Gs, Ss, Ss, Ss, Ss, Ss, Gs^Fms, Ww, Ww, Ww
Gs^Fms, Mm, Hh, Hh, Hh, Hh, Gs^Fms, Gs^Fms, Rb, Rb, Gs^Fms, Rb, Rb, Rb, Rb, Rb, Gs^Efm, Gs^Efm, Gs^Fms, Gs^Fms, Gs^Fms, Gs^Fms, Gs^Efm, Gg, Mm, Gs^Efm, Gs^Fms, Rb, Rb, Gs, Gs^Fms, Gs^Fms, Gs^Fms, Gg, Gg, Gs, Gg, Gg, Gs^Fms, Gs, Gs^Fms, Gs^Fms, Hh, Ww, Ww, Gs^Fms
Gs^Fms, Gs^Fms, Gs^Fms, Hh, Gs^Fms, Hh, Gs^Fms, Gs^Fms, Rb, Gs^Fms, Hh, Gs^Fms, Gs^Fms, Gs^Fms, Gg^Efm, Rb, Rb, Gs^Fms, Gs^Fms, Gs^Fms, Gg^Efm, Gs^Fms, Gs^Fms, Hh, Hh, Gs^Fms, Gs^Fms, Gs^Fms, Rb, Gs^Fms, Gs^Fms, Gs^Fms, Gs^Fms, Gs^Fms, Gs^Fms, Gs^Fms, Hh, Gs, Wwf, Gg, Wwf, Gs^Fms, Gs^Fms, Gs^Fms, Ww, Gs^Fms
Gs^Fms, Gs^Fms, Gs^Fms, Gs^Fms, Gs^Fms, Gs^Fms, Gs^Fms, Gg, Rb, Gs^Fds, Hh, Hh, Hh, Gg^Efm, Gs^Fms, Gg^Ve, Rb, Gs^Fms, Gs^Fms, Gs^Efm, Gg, Gg, Gs^Fms, Gs^Fms, Gs^Fms, Gg^Fet, Rb, Gs^Fms, Rb, Gs^Fms, Gs^Fms, Hh, Hh, Gs^Fms, Gs^Fms, Hh, Hh, Wwf, Gg, Wwf, Gs^Fms, Wwf, Ww, Ww, Gs^Fms, Gs^Fms
Gs^Fms, Gs^Fms, Gs^Fms, Gs^Fms, Gs^Fms, Gs^Fms, Rb, Rb, Gs^Fms, Gs^Fds, Hh, Mm, Hh, Gg^Efm, Hh, Hh, Gs^Fms, Rb, Gg, Gs^Fms, Gs^Fms, Gs, Gs^Efm, Gs^Fms, Gs^Fms, Rb, Gs^Fms, Rb, Gs^Fms, Gs^Fms, Hh, Mm, Gs^Fms, Gs^Fms, Gs^Fms, Gs^Fms, Ww, Ww, Gs^Fms, Gg, Gg, Gs^Fms, Gs^Fms, Gs^Fms, Gs^Fms, Gs^Fms
Gs^Fms, Gs^Fms, Gs^Fms, Gs^Fms, Gs^Vh, Gg, Rb, Gs^Fms, Gs^Fms, Gs^Fms, Gs^Fms, Hh, Gs^Fds, Gg^Efm, Gs^Fds, Gs^Fds, Gs^Fms, Rb, Rb, Gs^Fms, Rb, Gs^Efm, Gg, Gs^Edb, Rb, Rb, Gs^Fms, Gs^Fms, Gs^Fms, Gs^Fms, Gs^Fms, Hh, Gs^Fms, Gs^Fms, Gs^Fms, Ww, Gs, Gs^Fms, Gs, Gs^Fms, Gg, Gs^Fms, Gs^Fms, Gs^Fms, Rb, Rb
Gs^Fms, Gs^Fms, Gg^Fet, Gs^Fms, Hh, Hh, Hh, Rb, Rb, Gs^Fms, Gg^Fet, Gs^Fms, Gg^Efm, Gs^Fms, Gs^Fms, Gs^Fds, Rb, Rb, Gs^Fms, Rb, Gs^Fms, Rb, Rb, Rb, Gg, Gs^Fds, Gs^Fms, Gs^Fms, Gs^Fms, Hh, Hh, Gs^Fms, Gs^Fms, Gs^Fms, Gs^Fms, Ww, Ww, Gs^Fms, Gs^Fds, Gg, Gs^Fds, Gs^Fms, Gs^Fms, Rb, Gs^Fms, Gs
Gs^Fms, Gs^Fms, Hh, Hh, Hh, Hh, Gs^Fms, Gs^Fms, Rb, Gs^Fms, Gs^Fms, Hh, Gg^Efm, Gs^Fms, Gs^Fds, Gs^Fds, Rb, Gs^Fms, Gs^Fms, Gs^Fds, Gs^Fds, Gs^Fms, Gs^Fds, Gs^Fds, Gs^Fms, Gg, Gs^Edb, Gs^Fms, Gs^Fms, Hh, Gs^Fms, Gs^Fms, Rb, Gs^Fms, Rb, Rb, Ww, Gs^Fds, Gs^Fds, Gg, Gg, Gs^Vc, Rb, Rb, Gs^Fms, Gs^Fms
Gs^Fms, Gs^Fms, Mm, Mm, Mm, Hh, Gs^Fms, Gs^Fms, Rb, Gs^Fms, Gs^Fms, Gg^Efm, Gs^Fms, Gs^Fms, Gg, Gs^Fms, Rb, Gg^Fet, Hh, Gs^Fms, Gs^Fms, Gs^Fds, Gs^Fms, Gs^Fms, Gs^Fms, Gs^Fms, Gg, Gs^Fms, Hh, Gs^Fms, Rb, Rb, Wwf, Rb, Ww, Ww, Chw, Gs^Fms, Gs^Fds, Gs^Fds, Rb, Rb, Gs^Fms, Gs^Fms, Gs^Fms, Gs^Fms
Mm, Mm, Mm, Mm, Hh, Gs^Fms, Rb, Rb, Gs^Fms, Gs^Fms, Gs^Fms, Gs^Fms, Gs^Fms, Gg, Gs^Efm, Rb, Gg^Efm, Gs^Fds, Mm, Hh, Gs^Fms, Gs^Fds, Gs^Fms, Gs^Fms, Gs^Fms, Gg, Gs^Fms, Gs^Fms, Hh, Gs^Fms, Rb, Wwf, Ww, Ww^Vm, Ww, Chw, Chr, Gs^Fds, Gs^Fms, Rb, Gg^Fet, Gs^Fms, Gs^Fms, Gs^Fms, Gs^Fms, Gs^Fms
Mm, Mm, Mm, Mm, Gs^Fms, Gs^Fms, Rb, Gs^Fms, Gs^Fms, Hh^Vhh, Rb, Gg, Gs^Fms, Gg, Gs^Fms, Rb, Rb, Mm, Mm, Mm, Hh, Gg, Gg, Gs^Fds, Gg, Gg, Gs^Fms, Hh, Gg^Fet, Gs^Fms, Rb, Ww^Ewl, Ww, Ww^Ewf, Ww, Khw, Rb, Gs^Fms, Rb, Rb, Gs^Fms, Gs^Fms, Gs^Fms, Gs^Fms, Gs^Fms, Gs^Fms
Mm, Mm, Hh, Hh, Gg^Gvs, Rb, Rb, Gs^Fms, Gs^Fms, Hh, Rb, Gll^Fp, Hh, Hh, Gs^Fms, Gs^Fms, Rb, Hh, Hh, Hh, Gg, Gg, Gs^Fms, Gg, Gs^Fds, Gg, Gs^Fms, Hh, Gs^Fms, Gs^Fms, Gg, Rb, Ww, Ww, Wwf, Wwf, Rb, Rb, Gg, Gg, Gs^Fms, Gs^Fms, Gs^Fms, Gg^Fet, Hh, Hh
Hh, Hh, Gg^Gvs, Gg^Gvs, Gg, Gg, Gs^Fms, Rb, Rb, Rb, Gs^Fms, Gs^Fms, Gs^Fms, Gs^Fms, Rb, Rb, Gg, Gg^Efm, Gg^Efm, Gg, Hh, Hh, Hh, Gs^Fms, Gs^Fms, Gg, Gg, Gs^Fms, Gs^Fds, Gg, Gs^Vh, Rb, Rb, Ss, Rb, Wwf, Wwf, Gg, Gs^Fms, Gs^Fms, Gs^Fms, Gs^Fms, Hh, Hh, Mm, Mm
Gs^Fms, Gs^Fms, Rb, Gs^Vc, Rb, Gg, Rb, Rb, Ce, Rb, Rb, Gs^Fms, Rb, Rb, Gg, Gs^Vh, Ww, Ww, Ww, Hh, Hh, Mm, Hh, Gg, Gs^Fms, Gs^Fms, Gg, Gs^Fms, Gg, Gg, Gs^Fms, Gs^Fms, Gs^Fds, Rb, Gs^Fms, Rb, Ww, Gs^Fms, Ww, Gs^Fms, Gs^Fms, Gs^Fms, Hh, Mm, Mm, Mm
Rb, Rb, Gg, Rb, Gg, Rb, Rb, Ce, 1 Ke, Ce, Rb, Rb, Gs^Fms, Gg, Ww^Ewf, Ww, Ww, Gs^Fms, Ww, Gs^Fms, Hh, Mm, Mm, Mm, Hh, Gs^Fms, Gs^Fms, Gg, Gs^Fms, Gs^Fms, Gs^Fds, Hh, Gs^Fds, Gs^Fms, Gs^Fms, Rb, Rb, Ww, Gs, Ww, Hh, Gg^Fet, Mm, Mm, Mm, Mm
Gs^Fms, Gg, Hh, Gg, Hh, Gs^Fms, Rb, Ce, Ce, Ce, Rb, Gs^Fms, Gs^Fds, Ww, Ww, Ww^Ewl, Ww, Hh, Hh, Ww, Gs^Fms, Mm, Hh, Mm, Hh, Gs^Fms, Gs^Fms, Gs^Fms, Gs^Fds, Gs^Fds, Hh, Hh, Gs^Fds, Gs^Fds, Gs^Fms, Gs^Fms, Gs^Fms, Rb, Ww, Ww, Hh, Mm, Mm, Mm, Mm^Xm, Mm^Xm
Hh, Hh, Mm, Mm, Mm, Hh, Gg, Rb, Rb, Rb, Gs^Fms, Gs^Fds, Ww, Ww, Gs^Fds, Ww, Hh, Hh, Hh, Ww, Ww, Hh, Hh, Hh, Hh, Gs^Fms, Ww, Gs^Fms, Gs^Fds, Gs^Fds, Hh, Gs^Fds, Gs^Fds, Gs^Fds, Gs^Fms, Gs^Fms, Gs^Fms, Rb, Ww, Ww, Mm, Mm, Mm, Mm^Xm, Mm^Xm, Mm^Xm
Mm, Hh, Mm, Mm, Hh, Gg, Gs^Fms, Gs^Fms, Gs^Fms, Gs^Fms, Gs^Fms, Ww, Gs^Fms, Gs^Fds, Mm, Hh, Mm, Hh, Hh, Hh, Gs^Fms, Ww, Ww, Ww, Ww, Ww, Gs^Fms, Ww, Gs^Fds, Gs^Fds, Gs^Fds, Gs^Fds, Ww, Gs^Fms, Gs^Fms, Gs^Fms, Ww, Ww, Ww, Ww, Mm, Mm, Mm^Xm, Mm^Xm, Mm^Xm, Mm^Xm
Mm, Mm, Hh, Hh, Gs^Fms, Gs^Fms, Ww, Gs^Fms, Ww, Ww, Ww, Ww, Mm, Mm, Mm, Mm, Mm, Mm, Mm, Hh, Mm, Mm, Mm, Hh, Hh, Gs^Fms, Gs^Fms, Ww, Ww, Gs^Fds, Ww, Ww, Gs^Fds, Ww, Ww, Gs^Fms, Ww, Ww, Hh, Mm, Mm, Mm, Mm^Xm, Mm^Xm, Mm^Xm, Mm^Xm
Hh, Hh, Ww, Ww, Ww, Ww, Hh, Ww, Hh, Hh, Mm, Mm, Mm, Mm, Mm, Mm, Mm, Mm, Mm, Mm, Mm, Mm, Mm, Mm, Mm, Hh, Hh, Gs^Fms, Gs^Fms, Ww, Gs^Fms, Gs^Fds, Gs^Fds, Gs^Fds, Hh, Ww, Hh, Hh, Mm, Mm, Mm^Xm, Mm^Xm, Mm^Xm, Mm^Xm, Mm^Xm, Mm^Xm
Ww, Ww, Gg, Gg, Gs^Fms, Gs^Fms, Hh, Hh, Mm, Mm, Mm, Mm, Gs^Fms, Mm, Gs^Fms, Mm, Mm, Mm, Mm, Mm, Gs^Fms, Mm, Gs, Mm, Gs^Fms, Hh, Gs^Fms, Gs^Fms, Gs^Fds, Gs^Fms, Gs^Fds, Gs^Fds, Gs^Fds, Hh, Hh, Hh, Mm, Mm, Mm^Xm, Mm^Xm, Mm^Xm, Mm^Xm, Mm^Xm, Mm^Xm, Mm^Xm, Mm^Xm
