Mm, Mm, Hh, Mm, Hh, Mm, Mm, Mm, Mm, Ww, Hh, Mm^Xm, Mm^Xm, Mm^Xm, Mm^Xm, Mm^Xm, Mm^Xm, Mm^Xm, Mm^Xm, Ms^Xm, Ms^Xm, Ms^Xm, Ms^Xm, Ms^Xm, Ms^Xm, Md^Xm, Ww, Md^Xm, Ms^Xm, Ms^Xm, Ms^Xm, Ms^Xm, Md^Xm, Mm, Ms^Xm, Ms^Xm, Ms^Xm, Ms^Xm, Ms^Xm, Ms^Xm, Ms^Xm, Ms^Xm, Ms^Xm, Ms^Xm, Ms^Xm, Ms^Xm, Ms^Xm, Ms^Xm, Ms^Xm, Ms^Xm
Mm, Mm, Mm, Gs^Fms, Mm, Mm, Mm, Mm, Gs^Fms, Ww, Ww, Hh, Hh, Hh, Hh, Hh, Hh, Mm^Xm, Mm^Xm, Ms^Xm, Mm^Xm, Mm^Xm, Md^Xm, Ms^Xm, Md^Xm, Md^Xm, Ww, Md^Xm, Md^Xm, Ms^Xm, Md^Xm, Md^Xm, Md^Xm, Md^Xm, Md^Xm, Ms^Xm, Md^Xm, Ms^Xm, Md^Xm, Ms^Xm, Ms^Xm, Ms^Xm, Mm, Mm, Mm, Ms^Xm, Mm, Ms^Xm, Mm, Ms^Xm
Hh, Mm, Mm, Mm, Mm, Mm, Hh, Gs^Fds, Mm, Mm, Mm, Ww, Ww, Ww, Ww, Ww, Ww, Hh, Mm, Mm^Xm, Mm, Mm^Xm, Md^Xm, Md^Xm, Md^Xm, Ww, Mm, Mm, Mm, Md^Xm, Mm, Mm, Mm, Mm, Mm, Mm, Mm, Mm, Mm, Mm, Mm, Mm, Mm, Mm, Mm, Mm, Mm, Mm, Mm, Mm
Gs^Fms, Gs^Fms, Gs^Fms, Mm, Hh, Hh, Hh, Mm, Mm, Mm, Mm, Mm, Mm, Hh, Hh, Hh, Ww, Hh, Hh, Hh, Mm, Mm, Mm, Md^Xm, Mm, Ww, Ww, Mm, Mm, Mm, Mm, Mm, Mm, Mm, Hh, Gll^Fp, Gll^Fp, Mm, Gll^Fp, Mm, Mm, Mm, Hhd^Vhhr, Hhd, Hhd, Mm, Hh, Mm, Mm, Mm
Rb, Gs^Fms, Gg^Efm, Hh^Vhh, Gg, Gs^Fds, Gs^Fds, Gs^Fms, Gs^Fms, Mm, Gs^Fms, Mm, Hh, Hh, Mm, Mm, Mm, Ww, Ww, Hh, Hh, Mm, Mm, Mm, Gll^Fp, Mm, Ww, Mm, Mm, Mm, Mm, Hh, Hh, Hh, Gll^Fp, Gll^Fp, Gll^Fp, Gll^Fp, Gll^Fp, Gll^Fp, Gll^Fp, Mm, Rb, Hhd, Hh, Hh, Gll^Fp, Hh, Hh, Hh
Gg, Rb, Rb, Gg, Rb, Gs^Fms, Ce, Ce, Ce, Gs^Fds, Gs^Fds, Gs^Fds, Gg^Efm, Hh^Vhh, Hh, Mm, Mm, Mm, Mm, Ww, Ww, Hh, Hh, Gll^Fp, Gll^Fp, Gll^Fp, Ww, Hh, Hh, Mm, Mm, Hh, Rb, Gll^Fp, Rb, Rb, Rb, Gll^Fp, Rb, Gll^Fp, Rb, Rb, Gll^Fp, Cer, 3 Ker, Gll^Fp, Gll^Fp, Gll^Fp, Gll^Fp, Gll^Fp
Ds, Gg, Gg, Rb, Gg, Rb, Ce, 1 Ke, Ce, Gg, Rb, Gg, Gg, Gg, Gg^Em, Hh, Gll^Fp, Mm, Gs^Fds, Hh, Ww, Hh, Gg^Efm, Gg^Wm, Rb^Gvs, Rb^Gvs, Rb^Gvs, Ww, Ww, Hh, Gll^Fp, Rb, Gll^Fp, Rb, Gll^Fp, Gll^Fp, Gs^Fms, Rb, Gll^Fp, Rb, Gll^Fp, Gll^Fp, Gll^Fp, Cer, Cer, Gll^Fp, Gll^Fp, Gll^Fp, Gll^Fp, Gll^Fp
Ww, Ds, Ds, Gg, Ds, Gg, Gg, Ce, Gg^Efm, Rb, Gg, Rb, Rb, Gg, Rb, Gll^Fp, Rb, Rb, Rb, Ww, Gll^Fp, Gg^Efm, Gg^Efm, Gg^Efm, Gg, Rb^Gvs, Rb^Gvs, Rb^Gvs, Gs^Fds, Ww, Ww^Bw/r, Rb, Gs^Fms, Gll^Fp, Hh, Hh, Mm, Hh, Hh, Rb, Rb, Gll^Fp, Rb, Rb, Gll^Fp, Gll^Fp, Hh, Gll^Fp, Hh, Hh
Wo, Ww, Ww, Ds, Ww, Ds, Ds, Gg, Gg, Gg, Ds, Gg, Gs^Vh, Rb, Gs^Efm, Rb, Gs^Fds, Gs^Fds, Ww, Ww^Bw\, Rb, Gg, Rb, Rb, Rb, Gg^Es, Gg, Gs^Vh, Rb, Rb, Gs^Fms, Ww, Ww, Hh, Mm, Mm, Mm, Mm, Mm, Gs^Fms, Gs^Fms, Rb, Gll^Fp, Gll^Fp, Mm, Mm, Mm, Hh, Mm, Mm
Wo, Wo, Wo, Ww, Ww, Ww, Ww, Ds, Ds, Ds, Ww, Ds, Ds, Gs^Efm, Ds, Gs^Fms, Ds, Ds, Wwf, Gg, Gg^Efm, Rb, Gg, Gg, Gg^Efm, Rb, Rb, Rb, Rb, Gs^Fms, Gs^Fds, Gs^Fds, Ww, Hh, Hh, Mm, Mm, Mm, Mm, Mm, Gs^Fms, Rb, Rb, Gd^Vhr, Hhd, Mm, Mm, Mm, Mm, Mm
Wo, Wo, Wo, Wo, Wo, Ww, Wo, Ww, Ww, Ww, Ww, Ww, Ww, Ds, Wwf, Ds, Wwf, Wwf, Wwf, Ds, Ds, Gg^Efm, Ds, Ds, Ds, Gg, Gg, Gg^Efm, Gg^Efm, Rb, Rb, Gs^Fds, Ww, Gs^Fds, Gs^Fds, Hh, Mm, Mm, Mm, Ww, Ww^Ewl, Gs^Fms, Rb, Gll^Es, Gs^Fms, Hh, Hh, Mm, Hh, Mm
Ww, Wo, Ww, Wo, Wo, Wo, Wo, Wo, Wo, Wo, Wo, Ww, Ww, Ww, Ww, Wwf, Wwf, Ds, Ds, Wwf, Wwf, Ds, Wwf, Wwf, Wwf, Ds, Ds, Ds, Ds, Gg, Ww, Ww^Bw\, Rb, Gs^Fds, Rb, Hh, Hh^Vhh, Mm, Mm, Mm, Mm, Gs^Fms, Gs^Fms, Rb, Rb, Gs^Fms, Gs^Fms, Gs^Fms, Gs^Fms, Gs^Fms
Ds, Ww, Ds, Ww, Ww, Ww, Ww, Wo, Ww, Wo, Ww, Wo, Ww, Ww, Ww, Ww, Ww, Ww, Ww, Ds, Wwf, Wwf, Wwf, Wwf, Ww, Wwf, Ww, Wwf, Wwf, Ww, Gg, Gs^Fds, Gs^Fds, Rb, Gs^Fds, Rb, Gs^Fms, Hh, Hh, Mm, Hh, Hh, Gs^Fms, Gs^Fms, Rb, Gs^Fms, Gs^Fds, Gs^Fds, Gs^Fds, Gs^Fds
Gg, Ds, Gg, Ds, Ds, Ww, Ww, Ww, Ww, Ww, Ww^Vm, Ww, Ww, Ww, Ww, Ww, Ww, Wwf, Wwf, Wwf, Ds, Ds, Ds, Wwf, Wwf, Ww, Wwf, Ww, Wwf, Ds, Ds, Gs^Fds, Hh, Hh, Gs^Fms, Rb, Gs^Fms, Hh, Gs^Fms, Gs^Fms, Gs^Fms, Gs^Fms, Rb, Rb, Gs^Fms, Gs^Fms, Gs^Fms, Gs^Fms, Mm, Gs^Fms
Hh, Gg, Gg, Gg, Gg, Ds, Ds, Ww, Ds, Ds, Ds, Ds, Ds, Ww, Ww, Ww, Ww, Ww, Ww, Wwf, Wwf, Ds, Wwf, Ds, Wwf, Ww, Ww, Ww, Ww, Wwf, Wwf, Ds, Ds, Hh, Gs^Fds, Rb, Rb, Gs^Fms, Rb, Rb, Rb, Gs^Fms, Rb, Gs^Fms, Gs^Fms, Hh, Hh, Mm, Mm, Mm
Hh, Hh, Hh, Hh, Hh, Gg, Gg, Ds, Gg, Ds, Gg, Gg, Gg, Ds, Ds, Ww, Ww, Ww, Ww, Ww, Wwf, Wwf, Ds, Wwf, Ww, Wwf, Ww, Wwf, Wwf, Ww, Wwf, Wwf, Ww, Ds, Ds, Gs^Fds, Gs^Fds, Rb, Gs^Fds, Gs^Fds, Gs^Fds, Rb, Gs^Fds, Rb, Rb, Gs^Fms, Gs^Fms, Hh, Hh, Mm
Hh, Hh, Hh, Hh, Hh, Hh, Hh, Gg, Gs^Fms, Gg, Gs^Fms, Gg, Rb, Rb, Rb, Ds, Ds, Sm, Sm, Wwf, Wwf, Wwf, Wwf, Ds, Wwf, Ww, Wwf, Ww, Ww, Wwf, Ww, Ww, Ww, Ww, Ww, Ds, Ds, Ds, Ds, Ds, Ds, Gs^Fds, Gg, Gg, Rb, Gs^Fms, Gs^Fms, Gs^Fms, Gs^Fms, Gs^Fms
Mm, Hh, Mm, Hh, Mm, Mm, Hh, Hh, Hh, Gs^Fms, Gs^Fms, Gs^Fds, Gs^Fds, Gs^Fms, Rb, Rb, Rb, Rb, Rb, Sm, Chr, Chw, Chs, Wwf, Sm, Sm, Wwf, Ww, Ww, Ww, Ww, Ww, Ww, Ww, Ww, Ww, Ww, Ww, Ww, Ww, Ww, Ds, Ds, Gg, Gg, Rb, Rb, Gs, Gs, Gs^Fms
Mm, Mm, Mm, Mm, Mm, Mm, Mm, Hh, Hh, Hh, Gs^Fms, Hh, Hh, Hh, Hh, Gs^Fms, Rb, Ss^Vhs, Ss, Rb, Sm, 2 Khw, Rb, Sm, Ss, Ss^Vhs, Rb, Wwf, Sm, Ww, Ww, Ww, Ww, Wo, Wo, Ww, Ww, Ww, Ww, Ww, Ww, Ww, Ww^Vm, Ds, Gg, Gs^Fds, Gs^Fds, Rb, Rb, Rb
Mm, Mm, Mm, Mm, Mm, Mm, Mm, Mm, Mm, Gs^Fms, Gs^Fms, Gs^Fms, Hh, Gs^Fms, Gs^Fms, Rb, Rb, Sm, Sm, Rb, Ss, Sm, Ss, Rb, Rb, Ss, Rb, Sm, Sm, Sm, Sm, Ww, Ww, Ww, Ww, Wo, Wo, Wo, Wo, Ww, Wo, Ww, Ww, Ds, Ds, Gg, Gg, Gg, Gg, Gg
Md^Xm, Mm, Mm, Mm, Mm, Mm, Mm, Mm, Mm, Hh, Hh, Hh, Hh, Hh, Gs^Fms, Rb, Rb, Ss, Sm, Rb, Rb, Ss, Ss^Vhs, Ss, Sm, Rb, Gs^Fms, Rb, Rb, Sm, Rb, Ds, Ds, Ww, Ww, Ww, Ww, Ww, Ww, Wo, Wo, Wo, Ww, Ww, Ww, Ds, Ds, Ds, Ds, Ds
Md^Xm, Md^Xm, Md^Xm, Mm, Mm, Mm, Mm, Mm, Mm, Mm, Mm, Hh, Mm, Hh, Hh, Gs^Fms, Hh, Rb, Sm, Sm, Sm, Rb, Ss, Sm, Ss, Ss, Gs^Fms, Gs^Fms, Hh, Rb, Gs, Gs, Gg, Ds, Ww, Ww, Ww, Ww, Ww, Ww, Ww, Wo, Wo, Ww, Ww, Ww, Ww, Ww, Ww, Ww
Md^Xm, Md^Xm, Md^Xm, Md^Xm, Md^Xm, Mm, Mm, Mm, Mm, Mm, Mm, Mm, Mm, Mm, Mm, Hh, Ww, Sm, Sm, Sm, Ss, Ss, Ss, Sm, Gs^Fms, Hh, Gs^Fms, Hh, Gs^Fds, Gs^Fms, Hh, Hh, Hh^Vhh, Gg, Ww, Ds, Ds, Ds, Ds, Ww, Ww, Ww, Wo, Wo, Wo, Ww, Wo, Ww, Wo, Ww
Md^Xm, Md^Xm, Md^Xm, Md^Xm, Md^Xm, Md^Xm, Md^Xm, Mm, Mm, Mm, Mm, Mm, Mm, Mm, Hh, Ww, Hh, Ww, Ss, Sm, Sm, Ss, Sm, Sm, Ss, Gs^Fms, Hh, Gs^Fms, Mm, Mm, Mm, Mm, Mm, Hh, Hh, Ww, Ww, Gs^Fds, Gs^Fds, Gs^Fds, Gs^Fds, Ww, Ww, Wo, Wo, Wo, Wo, Wo, Wo, Wo
Md^Xm, Md^Xm, Md^Xm, Md^Xm, Md^Xm, Md^Xm, Md^Xm, Md^Xm, Md^Xm, Md^Xm, Md^Xm, Mm, Hh, Hh, Ww, Ww, Hh, Gs^Fms, Gs^Fms, Ss, Ss, Sm, Ss, Ss, Hh, Hh, Mm, Mm, Mm, Mm, Mm, Mm, Mm, Mm, Hh, Hh, Ww, Hh, Hh, Hh, Hh, Ww, Hh, Ww, Ww, Wo, Wo, Wo, Wo, Wo
Mm, Md^Xm, Md^Xm, Md^Xm, Md^Xm, Md^Xm, Md^Xm, Md^Xm, Md^Xm, Md^Xm, Md^Xm, Hh, Ww, Ww, Hh, Hh, Hh, Hh, Mm, Gs^Fms, Gs^Fms, Gs^Fms, Gs^Fms, Gs^Fms, Mm, Mm, Mm, Mm, Mm, Mm, Mm, Mm, Hh, Hh, Ww, Ww, Hh, Hh, Mm, Mm, Mm, Hh, Hh, Ww, Ww, Ww, Ww, Wo, Wo, Wo
