Mm^Xm, Mm^Xm, Mm^Xm, Mm^Xm, Mm^Xm, Mm^Xm, Hh, Wwg, Gll^Fmf, Mm^Xm, Mm^Xm, Mm^Xm, Mm^Xm, Mm^Xm, Mm^Xm, Mm^Xm, Mm^Xm, Mm^Xm
Mm, Mm^Xm, Mm, Mm^Xm, Mm, Mm^Xm, Gll^Fmf, Wwg, Wwg, Mm^Xm, Mm, Mm^Xm, Mm, Mm^Xm, Mm, Mm^Xm, Mm, Mm^Xm
Mm, Mm, Mm, Mm, Mm, Mm, Hh, Gll^Fmf, Wwg, Hh, Hh, Mm, Mm, Mm, Gll^Fmf, Hh, Gll^Fmf, Hh
Hh, Hh, Gll^Fmf, Hh, Gll^Fmf, Hh, Gs^Fms, Gs^Fms, Wwg, Hh, Gll^Fp, Gll^Fp, Gll^Fmf, Gll^Fmf, Gll^Fmf, Gll^Fp, Gll^Fp, Gll^Fmw
Gs^Fms, Gs^Fms, Gs^Fms, Gs^Fms, Gs^Fms, Gll^Fmf, Gs^Fms, Rb, Wwg, Rb, Rb, Gs^Fms, Gll, Gs^Fms, Gs^Fms, Gs^Fms, Gll^Fp, Gll^Fp
Gll, Gll, Gll, Gs^Fms, Gll, Gs^Fms, Gs^Fms, Rb, Rb, Wwg, Rb, Gll, Gll, Gll, Gll, Gll, Gll, Gll^Fp
Gll, Gll, Gll, Gll, Gll, Gll, Gll, Gll, Rb, 2 Wwg^Bw/, Wwg, Gll, Gs^Fds, Gll, Gll, 3 Gll, Gll, Gll
Gs^Fms, Gll^Fp, Gs^Fms, Gll, Hh, Gll, Gll, Gll, Rb, Rb, Wwf, Gs^Fds, Gs^Fds, Gs^Fms, Hh, Hh, Gs^Fms, Gll
Rb, Gs^Fms, Rb, Gs^Fms, Gs^Fds, Gs^Fms, Gs^Fds, Rb, Rb, Wwf, Rb, Wwf, Rb, Gs^Fds, Gs^Fds, Gs^Fms, Gs^Fds, Gs^Fds
Ww, Rb, Ww, 1 Rb, Rb, Gs^Fds, Rb, Rb, Ww, Ww, Ww, Ww, Ww, Rb, Rb, Gs^Fds, Gs^Fds, Gs^Fds
Ww, Ww, Ww, Ww, Ww, Rb, Ww, Ww, Ww, Ww, Ww, Ww, Ww, Ww, Ww, Rb, Rb, Rb
Wo, Ww, Wo, Ww, Ww, Ww, Ww, Ww, Wo, Wo, Wo, Wo, Wo, Ww, Ww, Ww, Ww, Ww
Wo, Wo, Wo, Wo, Wo, Ww, Wo, Wo, Wo, Wo, Wo, Wo, Wo, Wo, Wo, Ww, Ww, Ww
