Mm^Xm, Mm^Xm, Mm^Xm, Mm^Xm, Mm^Xm, Mm^Xm, Mm, Mm^Xm, Hh, Wwg, Ss, Gll^Fmf, Gll^Fmf, Hh, Hh, Mm, Mm, Mm, Mm, Mm, Hh, Hh, Hh, Gll^Fmf, Ss, Wwg, Wwg, Rb, Rb, Rb, Rb, Gll^Fmf, Gll^Fmf, Gll^Fmf, Rb, Rb, Rb, Rb
Mm, Mm^Xm, Mm, Mm^Xm, Mm^Xm, Mm^Xm, Mm, Mm, Hh, Wwg, Wwg, Ss, Ss, Gll^Fmf, Gll^Fmf, Hh, Mm, Mm, Mm, Mm, Hh, Hh, Gll^Fmf, Gll^Fmf, Ss, Sm, Sm, Wwg, Wwg, Wwg, Wwg, Rb, Wwg, Wwg, Wwg, Rb, Gll^Fmf, Gll^Fmf
Gll^Fmf, Hh, Gll^Fmf, Hh, Hh, Hh, Hh, Hh^Vhh, Gll^Fmf, Gll^Fmf, Gll^Fmf, Wwg, Sm, Gll^Fmf, Gll^Fmf, Hh, Hh, Mm, Mm, Hh, Gll^Fmf, Gll^Fmf, Gll^Fmf, Ss, Ss, Ss, Ss, Rb, Rb, Rb, Rb, Wwg, Rb, Rb, Rb, Wwg, Wwg, Gll^Fmf
Gll^Fmf, Gll^Fp, Gll^Fmf, Gll^Fmw, Gll^Fmf, Gll^Fmw, Gll^Fmf, Gll^Fmf, Ss, Gll^Fmf, Wwg, Wwg, Ss, Sm, Gll^Fmw, Gll^Fmf, Gll^Fmf, Hh, Hh, Hh, Rp^Vhcr, Gll^Fmf, Rb^Em, Ss, Sm, Ss, Rb, Ss^Bw/r, Ss, Ss^Vhs, Rb, Rb, Rb, Rb, Sm, Rp^Vhcr, Wwg, Gll^Fmf
Gs^Fms, Gll^Fmf, Gll^Fmf, Gll^Fmf, Gll^Fmf, Gll^Fmf, Chr, Chr, Chw, Wwg, Ss, Ss, Ss, Sm, Gll^Fdw, Gll^Fdw, Rb^Edb, Rb^Em, Rb^Em, Gll^Fmw, Rb, Rb, Rb, Rb, Rb, Rb, Rb, Rb^Edb, Ss, Ss, Chs, Chr, Chr, Gll^Fdw, Gll^Fdw, Wwg, Gll^Fmf, Rb
Gll^Efm, Gll, Gll, Gs^Vh, Gll^Fmf, Gll^Fmf, Chr, 1 Khr, Chs, Wwg, Wwg, Ss, Ss, Sm, Sm, Rb, Rb, Gll^Fdw, Rb, Rb, Rb, Rb, Ss, Rb, Sm, Rb, Rb, Ss, Ss, Ss, Chs, 2 Khr, Chr, Rb, Rb, Wwg, Gll^Fmf, Gll^Fmf
Gll^Efm, Gll^Efm, Gll, Gll, Gll, Gll^Efm, Gll, Chr, Ss, Ss, Rb, Wwg, Ss, Ss, Rb, Sm^Bw/r, Sm, Sm, Ss^Vhs, Ss, Ss, Sm, Sm, Ss, Sm, Rb, Rb, Rb, Rb, Rb^Em, Rb, Chs, Ss, Sm, Wwg, Wwg, Sm, Gll^Fmf
Gll^Fmf, Hh, Gll^Fmf, Gll, Gll, Gll, Rb, Rb, Rb, Rb, Wwg^Bw\r, Wwg, Sm, Rb, Rb, Rb, Sm, Sm, Rb, Gll^Fdw, Ss, Sm, Ss, Ss, Ss, Sm, Sm, Rb, Rb, Rb, Sm, Ss, Sm, Ss, Wwg, Ss, Sm, Sm
Gll^Fmf, Gll^Fmf, Gll^Fmf, Gll^Fmf, Gll^Fmf, Gll^Fmf, Ss^Vhs, Ss, Wwg, Wwg, Rb, Rb, Rb, Rb, Sm, Rb, Rb, Rb, Rb, Rb, Rb, Ss, Sm, Sm, Sm, Ss, Ss, Sm, Sm, Rb, Rb, Ss^Vhs, Ss, Sm, Sm, Sm, Sm, Ss
Rb, Gll^Fmf, Gs^Fds, Gll^Fmf, Gll^Fmf, Gll^Fmf, Ss, Ss, Wwg, Sm, Rb, Rb, Gll^Fdw, Gll^Fdw, Ss, Sm, Rb, Rb, Rb, Rb, Gll^Fdw, Ss, Rb, Sm, Rb, Gll^Fdw, Ss^Vhs, Ss, Gll^Fdw, Rb, Rb, Rb, Ss, Ss, Sm, Wwg, Ss, Sm
Ww, Rb, Rb, Rb, Rb, Rb, Sm, Wwg, Ss, Ss, Rb, Rb, Ss, Gll^Fdw, Ss, Rb, Ss, Rb, Gll^Fdw, Rb, Rb, Rb, Rb, Rb, Rb, Rb, Rb, Ss, Gll^Fdw, Rb, Rb, Rb, Ss^Bw\r, Rb, Rb, Sm, Sm, Ss
Ww, Ww, Ww, Ww, Ww, Sm, Wwg, Wwg, Ss, Rb, Rb, Ss^Vhs, Ss, Ss, Ss, Ss, Rb^Em, Ss, Ss, Gll^Fdw, Gll^Fmw, Rb, Rb, Rb, Rb, Rb, Ss, Ss, Ss, Gll^Fdw, Gll^Fdw, Rb, Ss, Rb, Rb, Rb^Edb, Ss, Sm
Wo, Ww, Ww, Ww, Ww, Ww, Ww^Vm, Ss, Ss, Gll^Fdw, Rb, Rb, Sm, Ss, Ss^Bw/r, Rb, Rb, Rb, Rb^Edb, Ss, Ss, Ss, Sm, Sm^Bw|r, Sm, Rb, Ss, Rb, Co, Ss, Ss, Ss, Ss, Gll^Fdw, Rb, Rb, Rb, Ss
Wo, Wo, Wo, Ww, Ww, Ww, Ww, Rb, Sm, Ss, Ss, Sm, Rb, Rb, Gll^Fdw, Ss, Rb, Rb, Rb^Edb, Rb^Edt, Rb, Rb, Rb, Rb, Ss^Vhs, Ss, Rb^Edb, Co, 3 Ke, Co, Rb^Em, Ss, Sm, Ss, Ss^Bw|, Rb, Rb, Rb
Ww, Wo, Wo, Wo, Wo, Ww, Ww, Ww, Sm, Sm, Sm, Rb, Rb, Gll^Fdw, Ss, Ss, Gll^Fdw, Gll^Fdw, Rb, Rb, Gll^Fdw, Sm, Rb, Rb, Rb, Rb, Rb, Co, Co, Co, Rb, Rb, Rb, Rp^Vhcr, Rb, Ss, Sm, Rb
Ww, Ww, Ww, Wo, Wo, Wo, Ww, Ww, Ww, Sm, Sm, Ss, Ss^Vhs, Rb, Sm, Ss, Ss, Gll^Fdw, Gll^Fdw, Rb, Rb, Gll^Fdw, Rb, Rb, Rb, Gll^Fdw, Rb, Gll^Fdw, Gll^Fdw, Rb, Rb, Rb, Rb, Rb, Rb, Rb, Sm, Sm
Rb, Ww, Ww, Wo, Wo, Wo, Wo, Ww, Ww, Ww, Ww, Sm, Sm, Sm, Sm, Sm, Sm, Ss, Ss, Ss, Ss, Rb, Ss, Rb, Ss, Rb, Rb, Gll^Fdw, Rb, Rb, Rb, Rb, Rb, Rb, Rb, Ss, Sm, Sm
Rb, Rb, Ww, Ww, Wo, Wo, Wo, Wo, Ww, Ww, Ww, Sm, Sm, Sm, Sm, Sm, Rb, Ss, Ss, Ss, Ss, Ss, Ss, Ss, Ss, Ss, Ss, Rb, Rb, Rb, Ss, Ss, Ss, Rb, Rb, Rb, Rb, Rb
