Ms, Ha, Aa, Re, Re, Ha, Aa^Fda, Ms, Ms, Ms, Ms, Ms, Ms, Ms, Ms, Ms, Ms, Mm, Mm, Mm, Mm, Ss, Mm, Ss, Ss, Ss, Ss, Ss, Gll^Ftr, Ss, Ss, Ss, Ss, Ss, Ss, Ss, Gs, Gs, Re, Ss, Ss, Ss, Ss, Wwg, Wwg, Wwg
Mm, Mm, Ha, Ha, Aa^Fda, Re, Ha, Ms, Gll^Fmf, Mm, Mm, Ms, Mm, Mm, Mm, Mm, Mm, Mm, Gll^Fmf, Mm, Gll^Ftr, Mm, Gll^Ftr, Ss, Gll^Ftr, Gll^Ftr, Gll^Ftr, Gll^Ftr, Gll^Ftr, Gll^Ftr, Gll^Ftr, Gll^Ftr, Gll^Ftr, Gll^Ftr, Gll^Ftr, Ss, Ss, Gs, Hh, Re, Re, Ss, Wwg, Wwg, Wwg, Wwg
Ms, Ms, Mm, Aa, Re, Re, Re, Hh, Gs, Gll^Fmf, Gs, Mm, Gs, Mm, Re, Gs, Re, Re, Re, Re, Re, Gd^Fts, Re, Gll^Ftr, Gll^Ftr, Gll^Ftr, Gll^Ftr, Gll^Ftr, Gll^Ftr, Gll^Ftr, Gll^Ftr, Gll^Ftr, Ss, Ss, Ss, Gll^Ftr, Gll^Ftr, Ss, Mm, Re, Re, Ss, Wwg, Wwg, Wwg, Wwg
Ms, Ms, Ha, Mm, Hh, Re, Re, Re, Re, Re, Re, Re, Re, Re, Ss, Re, Wwg, Ss, Ss, Re, Gll^Ftr, Re, Re, Re, Re, Ss, Ss, Gll^Ftr, Gll^Ftr, Gll^Ftr, Re, Ss^Vhs, Re, Gll^Ftr, Mm^Xm, Ss, Gll^Ftr, Mm, Re, Re, Ss, Wwg, Wwg, Wwg, Wwg, Wwg
Mm, Mm, Mm, Mm, Gll^Fmf, Gs, Re, Gs, Ss, Re, Ss, Re, Wwg, Wwg, Ss, Gll^Ftr, Ss, Wwg, Ss, Ss, Ss, Ss, Gs^Ft, Re, Chw, Re, Re, Gs^Ft, Re, Re, Re, Gll^Ftr, Re, Ss, Ss, Gll^Ftr, Gll^Ftr, Gll^Ftr, Re, Ss, Wwg, Wwg, Ss, Wwg, Ss, Wwg
Wwg, Mm, Mm, Mm, Mm, Gs, Re, Gs, Gs, Ss, Ss, Wwg, Wwg, Ss, Gll^Ftr, Gll^Ftr, Gll^Ftr, Wwg, Wwg, Ss, Ss, Ss, Gs^Ft, Chs, 4 Khw, Chr, Re, Re, Re, Gs^Ft, Gs^Ft, Re, Gs^Ft, Re, Re, Gs^Ft, Re, Re, Wwg, Wwg, Wwg, Wwg, Gs, Ss, Ss, Ss
Mm, Wwg, Wwg, Mm, Mm, Gs, Gll^Fmf, Re, Re, Ss, Wwg, Wwg, Ss, Gll^Ftr, Gll^Ftr, Ss, Ss, Gll^Ftr, Gll^Ftr, Wwg, Wwg, Ss, Gs^Ft, Chs, Chs, Chr, Hh, Gs^Ft, Gs^Ft, Re, Gs, Gs^Ft, Hh, Gs^Ft, Re, Re, Wwg^Bw\r, Wwg, Gs^Ft, Wwg, Gs, Gs, Gs, Gs, Re, Re
Mm, Mm, Mm, Wwg, Hh, Gs, Ss, Gll^Fmf, Re, Re, Re, Wwg, Ss, Gll^Ftr, Ss, Ss^Vhs, Ss, Gd^Fts, Gll^Ftr, Wwg, Wwg, Ss, Ss, Gs^Ft, Gs, Gs, Gs, Gs, Gs, Re, Re, Re, Re, Re, Wwg, Wwg, Gs^Ft, Re, Re, Gs^Vht, Re, Re, Re, Re, Ss, Ss
Mm, Mm, Hh, Wwg, Wwg, Gs, Ss, Ss, Re, Gs^Vht, Re, Wwg, Ss, Gll^Ftr, Gll^Ftr, Ss, Ss, Ss, Gll^Ftr, Ss, Re, Wwg, Wwg^Bw/, Re, Re, Gs, Re, Re, Re, Re, Wwg, Wwg, Wwg, Wwg, Wwg, Wwg, Wwg, Gs^Ft, Gs^Ft, Re, Re, Gd^Fts, Gd^Fts, Gs^Vht, Ss, Ss
Mm, Mm, Mm, Gll^Fmf, Ww, Wwg, Wwg, Re, Ss, Re, Ss, Ss, Ss, Ss, Gll^Ftr, Gll^Ftr, Gll^Ftr, Gll^Ftr, Ss, Re, Ss, Re, Ss, Wwg, Wwg, Re, Wwg, Re, Wwg, Wwg, Wwg, Ww^Ewl, Wwg, Wwg, Ss, Ss, Re, Wwg, Sm^Bw/r, Re, Gd^Fts, Gd^Fts, Gd^Fts, Gd^Fts, Ss, Ss
Mm, Mm, Hh, Hh, Sm, Wwg, Sm, Sm^Bw|, Ss, Ss, Ss, Ss, Gll^Ftr, Ss, Gll^Ftr, Gd^Fts, Gll^Ftr, Gll^Ftr, Re, Re, Ss, Ss, Ss, Ss, Ss, Wwg, Wwg, Wwg, Wwg, Wwg, Wwg, Wwg, Ss, Ss, Re, Re, Gll^Ftr, Re, Sm, Wwg, Wwg, Gs, Sm, Gs, Ss, Ss
Mm, Mm, Re, Re, Re, Sm, Ss, Re, Gll^Ftr, Ss, Ss, Ss, Ss, Gll^Ftr, Gd^Fts, Gll^Ftr, Ss, Ss, Re, Gs^Vht, Re, Re, Re, Re, Wwg^Bw\r, Wwg, Wwg, Wwg, Ss, Wwg, Wwg, Wwg, Wwg, Ss^Vhs, Re, Gll^Ftr, Mm, Mm, Mm^Xm, Sm, Gll^Ftr, Ss, Sm, Rb, Ss, Ss
Gll^Ftr, Gll^Ftr, Re, Gll^Ftr, Ss, Ss, Ss, Re, Re, Ss, Ss^Vhs, Ss, Ss, Gll^Ftr, Gll^Ftr, Gll^Ftr, Ss, Ss, Ss, Re, Ss, Ss, Ss, Wwg, Wwg, Re, Re, Gll^Ftr, Gll^Ftr, Ss, Gll^Ftr, Gll^Ftr, Gll^Ftr, Wwg, Wwg^Bw|, Re, Gll^Ftr, Mm, Mm, Mm, Gll^Ftr, Gll^Ftr, Ss, Sm, Sm, Ss
Gll^Ftr, Ss, Ss, Ss, Ss, Wwg, Wwg, Ss, Re, Re, Ss, Ss, Ss, Ss, Gll^Ftr, Gll^Ftr, Gll^Ftr, Ss, Ss, Ss, Ss, Ss, Wwg, Wwg, Gs, Gs^Ftp, Re, Re, Mm, Mm, Mm^Xm, Mm, Mm, Gll^Ftr, Re, Wwg, Gll^Ftr, Mm, Gd^Fts, Mm, Gll^Ftr, Gll^Ftr, Rb, Rb, Sm, Ss
Ss, Gll^Ftr, Gd^Fts, Gd^Fts, Gd^Fts, Ss, Wwg, Ss, Ss, Re, Re, Re, Re, Ss, Gll^Ftr, Ss, Gll^Ftr, Ss, Ss, Ss, Ss, Ss, Wwg, Re, Re, Re, Re, Re, Gs^Ftp, Mm, Mm, Mm^Xm, Mm, Gs^Ft, Re, Wwg, Wwg, Gll^Ftr, Sm, Gll^Ftr, Gll^Ftr, Gll^Ftr, Gll^Ftr, Rb, Gll^Ftr, Sm
Ss, Gll^Ftr, Gll^Ftr, Re, Re, Ss, Ss, Wwg, Wwg, Ss, Ww^Ewf, Ss, Ss, Re, Re, Gll^Ftr, Re, Gll^Ftr, Re, Ss, Sm, Wwf, Wwg^Bw/, Re, Re, Re, Re, Gs, Gs, Gs^Ftp, Gs^Ftp, Gs^Ftp, Gll^Ftr, Gs^Ft, Re, Gll^Ftr, Re, Wwg, Ss, Sm, Gll^Ftr, Gll^Ftr, Gll^Ftr, Rb, Gll^Ftr, Ss
Ss, Ss, Ss, Gll^Ftr, Gd^Fts, Gll^Ftr, Gd^Fts, Ss, Ss, Ss, Ss, Ss, Ss, Ss, Re, Re, Wwf, Re, Gll^Ftr, Re, Re, Re, Ss, Wwg, Wwg, Wwg, Re, Re, Re, Gs^Vht, Gs^Ftp, Gs^Ftp, Gll^Ftr, Re, Re, Re, Ww^Ewl, Wwg, Ss, Sm, Gll^Ftr, Gll^Ftr, Gll^Ftr, Gll^Ftr, Gll^Ftr, Ss
Ss, Ss, Gd^Fts, Gll^Ftr, Re, Gll^Ftr, Gll^Ftr, Gll^Ftr, Ss, Ww^Ewl, Wwg, Ss, Re, Re, Ss, Wwf, Ss, Wwf, Wwf, Chs, Chs, Ss, Wwg, Ww^Ewl, Ss, Wwg, Wwg, Re, Wwg, Re, Re, Re, Re, Re, Re, Re, Re, Wwg, Ss, Sm, Sm, Gll^Ftr, Gll^Ftr, Gll^Ftr, Gll^Ftr, Ss
Ss, Ss, Gd^Fts, Re, Gd^Fts, Ss, Ss, Ss, Ss, Wwg, Ss, Ss, Re, Gs^Vht, Ss, Ss, Ss, Wwg, Wwg, 2 Khs, Chw, Wwg, Ss, Ss, Ss, Ss, Ss, Wwg, Wwg, Re, Wwg^Bw\, Wwg, Wwg, Wwg, Wwg, Wwg, Wwg, Wwg, Ss, Ss, Sm, Gll^Ftr, Gll^Ftr, Gll^Ftr, Sm, Sm
Ss, Ss, Gd^Fts, Re, Ss, Gd^Fts, Ss, Ss, Ss, Wwg, Wwg, Ss, Ww^Ewl, Re, Ss, Ww^Ewf, Ss, Ss, Ss, Wwg, Wwg, Wwg, Ss, Ss, Ss, Ss, Ss, Ss, Ss, Wwg, Re, Re, Sm, Sm, Gll^Ftr, Wwg, Wwg, Ss, Ss, Ss, Ss, Sm, Sm, Gll^Ftr, Sm, Ss
Ss, Ss, Ss, Ss, Ss, Ss, Gll^Ftr, Ss, Ss, Ss, Ss, Wwg, Sm^Bw/, Re, Ss, Ss, Ss, Ss, Wwg, Wwg, Wwg, Ss, Ss, Ss, Ss, Ss, Sm, Ss, Sm, Sm, Sm, Re, Re, Re, Gll^Ftr, Hh, Wwf, Ss, Ss, Ss, Ss, Ss, Ss, Sm, Ss, Ss
Ss, Ss, Gll^Ftr, Gll^Ftr, Gd^Fts, Re, Re, Re, Ww^Ewl, Ss, Re, Re, Ss, Ss, Wwg, Ss, Wwg, Wwg, Ss, Ss, Wwg, Ss, Ss, Ss, Sm, Sm, Re, Sm, Re, Re, Sm, Re, Re, Re, Re, Sm, Wwf, Ss, Wwg, Ss, Wwg, Ss, Ss, Ss, Ss, Ss
Ss, Gll^Ftr, Ss, Gll^Ftr, Gll^Ftr, Gll^Ftr, Gll^Ftr, Re, Gll^Ftr, Ss, Re, Ww^Ewl, Ss, Wwg, Ww^Ewl, Wwg, Ss, Ww^Ewl, Re, Ss, Wwg, Wwg, Ss, Sm, Re, Re, Gll^Ftr, Re, Re, Sm, Re, Re, Sm, Re, Wwf, Wwf^Bw\r, Re, Wwf, Re, Wwg, Gll^Ftr, Wwg, Wwg, Ss, Wwg, Ss
Ss, Gll^Ftr, Ss, Ss, Ss, Gd^Fts, Gll^Ftr, Gll^Ftr, Gll^Ftr, Ss, Gll^Ftr, Re, Ss, Ss, Ss, Ss, Ss, Re, Ss, Ss^Vhs, Wwg, Ss, Ss, Sm, Re, Gs^Ft, Gs^Ft, Gll^Ftr, Re, Sm, Sm, Sm, Wwf, Wwf, Wwg, Re, Re^Em, Re^Em, Re, Wwg, Wwg, Wwg, Re, Wwg, Re^Vct, Wwg
Ss, Gll^Ftr, Ss, Ss, Ss, Gll^Ftr, Gll^Ftr, Ss, Gd^Fts, Ss, Re, Re, Ww^Ewl, Ss, Ss, Ss, Ss, Re, Wwg, Wwg, Ss, Ss, Ss, Sm, Sm, Re, Re, Gs^Ft, Re, Re, Sm, Wwf, Ss, Ss, Wwg, Re, Re, Re, Gs, Gs, Gs, Re, Gll^Ftr, Re, Re, Re
Ss, Gll^Ftr, Gll^Ftr, Ss, Ss, Ss, Gll^Ftr, Gll^Ftr, Gll^Ftr, Gll^Ftr, Re, Gll^Ftr, Ss, Ss, Ss, Ss, Ss, Re, Ss, Ss, Ss, Gll^Ftr, Re, Ss, Sm, Sm, Sm, Re, Sm, Sm, Ww^Vm, Wwf, Wwg, Wwg, Wwg, Re, Re, Gs, Gs, Gll^Ftr, Gs, Gll^Ftr, Gs, Gll^Ftr, Gs, Re
Ss, Gd^Fts, Gll^Ftr, Gll^Ftr, Gll^Ftr, Gll^Ftr, Gll^Edb, Gll^Edb, Gll^Edb, Re, Ww^Ewl, Re, Gll^Ftr, Ss, Gll^Ftr, Gd^Fts, Gll^Ftr, Re, Re, Re, Re, Re, Ss, Sm, Ww^Vm, Sm, Wwg, Sm, Wwf, Wwf, Wwg, Wwg, Wwf, Re, Re, Re^Em, Re, Gd^Fts, Gs, Gs, Ce, Ce, Ce, Gll^Ftr, Gd^Fts, Ss
Ss, Ss, Gll^Ftr, Gll^Ftr, Gll^Ftr, Gll^Ftr, Gll^Ftr, Gll^Edb, Gll^Ftr, Ss^Vhs, Gll^Ftr, Re, Re, Gll^Ftr, Ww^Ewl, Ss, Re, Re, Gll^Ftr, Ss, Ss, Ss, Sm, Sm, Wwg, Wwg, Wwg, Wwg, Wwg, Ww^Ewl, Wwf, Re^Em, Re, Wwf, Re, Re^Em, Re^Vct, Gll^Ftr, Gll^Ftr, Gs, Ce, 1 Ke, Ce, Gs, Gll^Ftr, Gs
Ss, Gll^Ftr, Gll^Ftr, Gll^Ftr, Gll^Ftr, Gll^Ftr, Sm, Rb, Gll^Ftr, Wwg, Gll^Ftr, Gd^Fts, Chs, Re, Re, Ss^Bw/, Gll^Ftr, Gs^Vht, Gll^Ftr, Ss, Ss, Ss, Sm, Ww^Ewl, Wwg, Wo, Wo, Wwg, Wwg, Wwg, Wwf, Wwf, Wwg, Wwf, Wwg, Re^Em, Re, Re, Gs, Gs, Gs, Ce, Gs, Gs, Gll^Ftr, Gs
Ss, Gd^Fts, Gll^Ftr, Gll^Ftr, Ss, Ss, Rb, Rb, Gll^Ftr, Wwg, Wwg, Chs, 3 Khs, Ch, Re, Ss, Gll^Ftr, Gll^Ftr, Gd^Fts, Gll^Ftr, Gll^Ftr, Ss, Sm, Wwg, Wwg, Wo, Wwg, Wwg, Wwf, Wwf, Wwf, Ss, Ss, Wwg, Re, Re, Re^Em, Re, Gs, Gs, Gll^Ftr, Gs, Gs, Gs, Gs, Gs
Ss, Gll^Ftr, Gll^Ftr, Ss, Ss, Sm, Rb, Ww^Ewl, Ss, Gll^Ftr, Wwg, Chs, Chs, Chs, Gd^Fts, Ss, Gll^Ftr, Ss, Gll^Ftr, Gll^Ftr, Ss, Ss, Ss, Wwf, Wwf, Wwg, Wwf, Wwf, Ss, Wwf, Ss, Ss, Rb, Wwf, Wwf, Re, Re, Re^Em, Re^Em, Gs, Re, Gs, Re, Re^Vct, Re, Gs
Ss, Gll^Ftr, Gll^Ftr, Ss, Sm, Sm, Rb, Ss, Ss^Vhs, Gd^Fts, Gll^Ftr, Wwg, Rb, Rb, Gll^Ftr, Gll^Ftr, Gll^Ftr, Ss, Ss, Gll^Ftr, Ss, Ss, Ss, Ss, Ss, Ww^Vm, Ss, Ss, Ss, Ss, Ss, Ss^Vhs, Rb, Rb, Wwf, Ss, Wwg, Re, Re^Em, Re, Re, Re, Re, Re, Re, Re
Ss, Ww^Ewl, Ss, Gll^Ftr, Rb, Rb, Ss, Rb, Rb, Rb, Rb, Rb, Gll^Ftr, Gd^Fts, Ss, Gll^Ftr, Gll^Ftr, Ww^Ewl, Ss, Gll^Ftr, Gll^Ftr, Ss, Ss, Ss, Ss, Ss, Ss, Ss, Ss, Ss, Ss, Sm, Sm, Sm, Ss, Wwg, Wwg, Wwg, Wwg, Re^Em, Wwg, Wwg, Wwg, Wwg, Wwg, Wwg
Ss, Ss, Gll^Ftr, Rb, Gll^Ftr, Gll^Ftr, Gll^Ftr, Gd^Fts, Gll^Ftr, Gll^Ftr, Ss, Ss, Ss, Ss, Ww^Ewl, Gll^Ftr, Gll^Ftr, Ss, Ss, Ss, Ss, Gll^Ftr, Gll^Ftr, Gll^Ftr, Ss, Ss, Ss, Ss, Ss, Ss, Ss, Ss, Ss, Ss, Ss, Ss, Ss, Ss, Ss, Wwg, Ss, Wwg, Wwg, Wwg, Ss, Ss
Ss, Gll^Ftr, Rb, Rb, Ss, Ss, Ss, Gll^Ftr, Ss, Ss, Ss, Ss, Ss, Ss, Ss, Gll^Ftr, Gll^Ftr, Ss, Ss, Ss, Ss, Ss, Ss, Gll^Ftr, Gll^Ftr, Ss, Ss, Ss, Ss, Ss, Ss, Ss, Ss, Ss, Ss, Ss, Ss, Ss, Ss, Ss, Ss, Ss, Ss, Ss, Ss, Ss
