Ms^Xm, Ms^Xm, Ms^Xm, Ms^Xm, Ms^Xm, Ms^Xm, Ms^Xm, Ms^Xm, Ms^Xm, Ms^Xm, Ms^Xm, Ms^Xm, Ms^Xm, Ms^Xm, Ha, Ha, Ha, Aa^Fma, Ai, Aa^Fma, Aa^Fpa, Ha, Aa^Fma, Ms, Ms, Ms, Ms^Xm, Aa^Fma, Ms^Xm, Aa^Fpa, Ms^Xm, Ms^Xm, Ms^Xm, Ms^Xm, Ms^Xm, Ms^Xm, Ms^Xm, Ms^Xm, Ms^Xm, Ms^Xm, Ms^Xm, Ms^Xm, Ms^Xm, Aa, Ms^Xm, Ms^Xm
Ms^Xm, Ms^Xm, Ms^Xm, Ms^Xm, Ms^Xm, Ms^Xm, Ms, Ms^Xm, Ms, Ms, Ms, Ms, Ms, Ha, Ha, Ha, Aa^Fma, Aa^Fma, Aa^Fma, Ai, Aa^Fpa, Ha, Ha, Aa^Fpa, Ha, Ha, Ha, Ms, Ms, Ms, Ms^Xm, Ms^Xm, Ms^Xm, Ms^Xm, Ms^Xm, Ms^Xm, Ms^Xm, Ms^Xm, Ms^Xm, Ms^Xm, Ms^Xm, Ms^Xm, Ms^Xm, Ms^Xm, Ms^Xm, Ms^Xm
Ms^Xm, Ms^Xm, Ms, Ms, Ms, Ms, Ha, Ms, Ms, Ms, Ms, Ms, Ms, Ha, Ha, Aa^Fda, Aa^Fpa, Aa^Fma, Aa^Fpa, Ww, Ww^Bw/, Rb, Rb, Ha, Ms, Aa^Fma, Aa^Fma, Aa^Fpa, Aa^Fpa, Ms, Ms, Ms^Xm, Ms^Xm, Ms^Xm, Ms^Xm, Ms^Xm, Ms^Xm, Ms^Xm, Ms^Xm, Ms^Xm, Ms^Xm, Ms^Xm, Ms^Xm, Ms^Xm, Ms^Xm, Ms^Xm
Ms, Ms, Ha, Ms, Ha, Ha, Ms, Ha, Aa^Fpa, Aa^Fpa, Ha, Ms, Ha, Ha, Aa^Fma, Ha, Aa^Fda, Aa^Fma, Rb, Rb, Ai, Aa^Fma, Rb, Ha, Ha, Ha, Rb, Aa^Fda, Aa, Ha, Ha, Ms, Ms, Ms, Ms, Ms^Xm, Ms, Ms, Ms, Ms^Xm, Ms^Xm, Ms^Xm, Ms, Ms^Xm, Ms, Ms
Ms, Ms, Ms, Ha, Ha, Ms, Ha, Ha, Ha, Ha, Ms, Ha, Ms, Ms, Ms, Aa^Fma, Ha, Aa^Fpa, Rb, Aa^Fma, Ww, Aa^Vca, Aa^Fpa, Rb, Rb, Rb, Aa^Fma, Rb, Rb, Ha, Ha, Aa^Fpa, Ms, Ms, Ms, Ms, Ms, Ms, Ms, Ms, Ms, Ms, Ms, Ms, Ms, Ms
Aa^Fpa, Ms, Ha, Ha, Ms, Ha, Ms, Ms, Ha, Ha, Ha, Ha, Cea, Ms, Aa^Fpa, Aa^Fpa, Ha, Rb, Aa^Fda, Aa, Ww, Ha, Ai, Aa^Fpa, Ha, Aa^Fma, Aa^Fpa, Aa, Aa^Fpa, Rb, Rb, Aa^Fpa, Ms, Ms, Ms, Aa^Fpa, Ha, Ms, Ms, Ms, Ms, Ms, Ha, Ms, Ha, Ha
Aa, Aa^Fma, Aa^Fpa, Aa^Fma, Ha, Ha, Ha, Ha, Ms, Ms, Ms, Aa^Fpa, 2 Kea, Cea, Ha, Ha, Rb, Rb, Aa^Fda, Aa^Fpa, Aa^Fma, Ww, Ww, Ai, Ai, Ms, Ms, Ha, Ha, Aa^Fpa, Rb, Aa, Aa^Fda, Ms, Ha, Ha, Ha, Aa^Fma, Ms, Ms, Ms, Ha, Ai, Ha, Ai, Ai
Rb, Aa, Aa, Ha, Aa^Fda, Ha, Ha, Ha, Ms, Ms, Aa^Fpa, Aa^Fma, Cea, Cea, Rb, Rb, Aa, Aa, Ai, Ai, Ai, Ww, Ww, Ww, Ww, Ai, Ha, Ha, Aa^Fpa, Rb, 3 Aa^Fma, Aa, Ha, Ha, Aa^Fpa, Ms, Ha, Ha, Ha, Ms, Ai, Ai, Ha, Ai, Ha, Ha
Aa, Rb, Rb, Aa^Fma, Rb, Aa, Aa^Fpa, Ms, Ms, Ms, Aa^Fpa, Aa^Fpa, Aa^Fpa, Rb, Aa^Fpa, Aa^Fma, Chw, Ww, Ww, Ww, Ww, Ww, Ww, Ww, Ww, Ai, Ai, Ms, Aa^Fpa, Rb, Aa^Fpa, Aa^Fpa, Ha, Aa^Fma, Ms, Ms, Ha, Aa^Fda, Aa^Fpa, Ai, Ha, Ha, Ms, Ms, Ms, Ms
Aa, Aa^Fpa, Aa, Rb, Aa^Fpa, Rb, Aa^Fda, Aa^Fpa, Aa^Voa, Ms, Aa^Fma, Aa^Fma, Rb, Rb, Ha, Ai, Ww^Es, Ww, Ww, Ww, Ai, Ww, Ai, Ww, Ww, Ww, Ai, Aa^Fpa, Rb, Rb, Aa^Fma, Ha, Ms, Ms, Ms, Ms, Ha, Aa^Fpa, Ai, Ai, Ms, Ms, Ms, Ms, Ms, Ms^Xm
Ww, Aa, Aa, Aa^Fpa, Aa, Rb, Rb, Rb, Rb, Aa, Aa, Rb, Aa, Ha, Ha, Wwf, Ww, Ww, Ha, Ha, Aa, Ww, Aa^Fma, Ai, Aa^Fpa, Ai, Aa^Fpa, Aa^Fpa, Rb, Aa^Fda, Ha^Vhha, Ha, Ms, Ms, Ha, Ha, Ai, Ai, Ha, Ha, Ms, Ms, Ms, Ms, Ms, Ms^Xm
Ai, Ww, Ai, Aa, Aa^Fpa, Aa^Fpa, Aa^Fma, Aa, Rb, Aa^Fma, Rb, Rb, Aa^Fpa, Aa^Fpa, Ww, Aa, Ww, Ai, Ms, Ha, Aa^Fma, Ww, Ww, Aa^Fpa, Aa^Fma, Aa^Fda, Aa, Aa^Fda, Rb, Aa, Aa, Ms, Ms, Ms, Ha, Aa^Fda, Ai, Ha, Ms, Ms, Ms, Ms, Ms, Ms, Ms, Ms
Ha, Ww, Ww, Aa^Fma, Ai, Aa^Fda, Aa, Aa^Fma, Aa, Rb, Aa^Fma, Aa, Ai, Ww, Ai, Ww, Ai, Ai, Ha, Aa^Fpa, Ms, Aa^Fpa, Aa^Fda, Ai, Aa, Aa, Rb, Rb, Aa^Fma, Rb, Rb, Aa, Aa, Ha, Ww, Ai, Aa^Fma, Ms, Ms, Ms, Ms, Ms, Ms, Ms, Ms, Ms
Ms, Ai, Ww, Ai, Ww, Ai, Ww, Aa, Aa, Rb, Ai^Bw\, Ai, Ww, Ai, Aa, Ai, Aa^Vca, Aa^Fda, Aa^Fda, Aa^Fma, Aa, Aa^Fda, Aa, Ai, Ai^Bw/, Rb, Aa, Aa^Fma, Aa, Aa^Fma, Aa, Rb, Ww^Bw\, Ww, Aa, Aa, Aa, Aa^Fda, Aa^Vha, Ms, Aa^Fma, Ms, Aa^Fpa, Ms, Ms, Ms
Ms, Aa^Fpa, Aa^Fpa, Ww, Ha, Ww, Ai, Ww, Ww, Ai, Ai, Ww^Bw\, Rb, Aa, Rb, Aa, Aa, Aa, Aa, Aa, Rb, Rb, Rb, Rb, Aa, Ai, Ai, Aa, Aa^Fma, Aa, Aa^Fpa, Ww, Aa, Rb, Rb, Rb, Rb, Aa, Aa, Aa^Fpa, Ha, Aa^Fda, Aa^Fma, Aa^Fma, Aa^Fma, Aa^Fpa
Ms, Ms, Ms, Ha, Ha, Ha, Aa^Fpa, Ai, Ha, Ai, Aa, Aa, Aa, Rb, Aa, Rb, Rb, Aa, Rb, Rb, Aa^Fda, Aa, Aa^Fma, Aa, Aa^Fpa, Aa^Fma, Ai, Ha, Ha, Ms, Ai, Ai, Aa^Fpa, Aa, Aa, Aa, Rb, Aa, Aa, Aa, Aa, Ha, Aa^Fda, Aa^Fma, Aa^Fpa, Aa^Fpa
Ms, Ms, Ms, Ms, Ha, Aa^Fma, Aa^Fpa, Ms, Ha, Aa^Fpa, Aa^Fpa, Aa^Fpa, Aa^Fma, Aa^Fma, Aa^Fma, Aa, Aa, Rb, Aa^Fma, Aa^Fda, Ha, Ha, Ms, Ha^Vhha, Ms, Ms, Ms, Ww, Ww, Ai, Ha, Ms, Ha, Aa^Fpa, Aa^Fpa, Aa, Aa, Rb, Cea, Cea, Cea, Aa, Aa^Fpa, Aa^Fpa, Ms, Ms
Ms^Xm, Ms, Ms, Aa^Fpa, Ms, Ha, Ha, Aa^Fda, Ha, Ms, Ms, Ha, Ha, Aa^Fda, Ha, Aa^Fda, Ha, Aa^Fpa, Aa^Fpa, Ha, Ha, Ms, Ms, Ms, Ms, Ms, Ms, Ms, Ms, Ai, Ha, Aa^Fpa, Ha, Ha, Aa^Fpa, Aa^Fma, Aa^Fma, Aa, Cea, 1 Kea, Cea, Aa, Aa^Fda, Ha^Vhha, Ms, Ms
Ms^Xm, Ms, Ms, Ms, Ms, Ms, Ha, Ha, Ms, Ms, Aa^Fpa, Aa^Fpa, Ha, Ha, Aa^Fda, Ha, Ms, Ms, Ms, Aa^Fda, Ha, Ha, Ha, Aa^Fpa, Ms, Ms, Ms, Ms, Ai, Ai, Ha, Aa^Fma, Ms, Ha, Ha, Aa^Fpa, Aa, Aa^Fda, Aa, Cea, Rb, Aa, Aa^Fda, Ha, Ha, Ms
Ms^Xm, Ms^Xm, Ms^Xm, Ms, Ms, Ms, Ms, Ms, Ms, Ms, Ms, Ms, Ms, Aa^Fpa, Ha, Aa^Fda, Aa^Fpa, Ms, Ms, Aa^Fpa, Aa^Fpa, Ha, Ha, Ms, Ha, Ms, Ha, Ww, Ha, Ha, Aa^Fpa, Ms, Ms, Ms, Ha, Aa^Vca, Aa^Fma, Aa, Aa^Fda, Aa, Rb, Aa, Aa, Aa^Fda, Aa^Fpa, Aa^Fpa
Ms^Xm, Ms^Xm, Ms^Xm, Ms^Xm, Ms^Xm, Ms, Ms^Xm, Ms, Ms, Ms, Ms, Ms, Ms, Ms, Ms, Ha, Ha, Ha, Ha, Ms, Ha, Ms, Ha, Ha, Ha, Ha, Ha, Ai, Ai, Aa^Fpa, Aa^Fda, Ha, Ha, Ms, Ms, Ha, Ha, Aa^Fpa, Aa^Fpa, Aa^Fda, Aa^Fpa, Rb, Rb, Aa, Ha, Aa^Fpa
Ms^Xm, Ms^Xm, Ms^Xm, Ms^Xm, Ms^Xm, Ms^Xm, Ms^Xm, Ms^Xm, Ms^Xm, Ms^Xm, Ms^Xm, Ms, Ms, Ms, Ms, Ms, Ms, Ms, Ms, Ha, Ms, Ha, Ms, Aa^Fma, Ms, Aa^Fpa, Aa^Fma, Ha, Ai, Aa^Fpa, Ha, Aa^Fda, Ha, Ms, Ms, Ms, Ha, Ha, Ha, Aa^Fpa, Aa^Fpa, Aa^Fpa, Rb, Aa, Aa, Ha
Ms^Xm, Ms^Xm, Ms^Xm, Ms^Xm, Ms^Xm, Ms^Xm, Ms^Xm, Ms^Xm, Ms^Xm, Ms^Xm, Ms^Xm, Ms^Xm, Ms^Xm, Ms^Xm, Ms^Xm, Ms^Xm, Ms^Xm, Ms, Ms, Ms, Ms, Ms, Ms, Ms, Ms, Aa^Fpa, Aa^Fda, Ww, Ha, Aa^Fda, Ha, Ha, Ms, Ms, Ms, Ms, Ms, Ha, Ha, Ha, Aa^Fma, Aa^Fpa, Aa^Fda, Rb, Rb, Aa
Ms^Xm, Ms^Xm, Ms^Xm, Ms^Xm, Ms^Xm, Ms^Xm, Ms^Xm, Ms^Xm, Ms^Xm, Ms^Xm, Ms^Xm, Ms^Xm, Ms^Xm, Ms^Xm, Ms^Xm, Ms^Xm, Ms^Xm, Ms^Xm, Ms^Xm, Ms, Ms, Ms, Ms, Ms, Ms, Aa^Fpa, Aa^Fpa, Ww, Ha, Aa^Fda, Ha, Ms, Ms, Ms^Xm, Ms^Xm, Ms, Ms^Xm, Ms, Ms, Aa^Fpa, Aa^Fpa, Aa^Fpa, Aa^Fda, Aa^Fda, Aa, Rb
