Mm^Xm, Mm^Xm, Mm^Xm, Mm^Xm, Mm^Xm, Mm^Xm, Mm^Xm, Mm^Xm, Mm^Xm, Md, Md, Xu, Xu, Xu, Xu, Xu, Ur, Uu, Xu, Xu, Xu, Xu, Xu, Xu, Xu, Wo, Ha, Mm, Ha, Ha, Ha, Ha, Ha, Ms, Ms, Ms, Ms^Xm, Ms^Xm, Ms^Xm, Ms^Xm, Ms^Xm, Ms^Xm, Ms^Xm, Ms^Xm, Ms^Xm, Ms^Xm
Mm^Xm, Mm^Xm, Mm^Xm, Mm^Xm, Mm^Xm, Mm^Xm, Mm, Mm^Xm, Hh, Md, Hh, Md, Hh, Xu, Xu, Uh, Ur, Uu, Xu, Xu, Gll^Fmf, Xu, Gll^Fmf, Gll^Fp, Wo, Wo, Gll^Fp, Ms, Ha, Ha, Ms, Ha, Ha, Ha, Ha, Ms^Xm, Ms, Ms^Xm, Ms^Xm, Ms^Xm, Ms^Xm, Ms^Xm, Ms^Xm, Ms^Xm, Ms^Xm, Ms^Xm
Mm^Xm, Mm^Xm, Mm^Xm, Mm^Xm, Mm, Mm, Hh, Hh, Mm, Hh, Hh, Hh, Hh, Xu, Xu, Uu, Uu, Ur, Uu, Xu, Ww, Wo, Wo, Wo, Gll^Fmf, Gll^Fp, Hd, Gll^Fp, Hh, Ms, Ms, Ms, Ha, Ms, Ms, Ms, Ms, Ms, Ms, Ms, Ms, Ms^Xm, Ms^Xm, Ms^Xm, Ms^Xm, Ms^Xm
Mm^Xm, Mm^Xm, Mm, Mm, Mm, Hh, Mm, Mm, Gll^Fp, Hh, Co, Co, Co, Hh, Hh, Xu, Rb, Rb, Gll^Fdf, Gll^Fdf, Wo, Hh, Hh, Ha, Gll^Fmf, Aa^Fpa, Gll^Fmf, Aa^Fpa, Ha, Ms, Ms, Ms, Coa, Aa^Fpa, Aa^Fpa, Ms, Ms, Ms, Ms, Ms, Ms, Ms, Ms, Ms, Ms, Ms
Mm^Xm, Mm, Mm, Mm, Mm, Hh, Hh, Gll^Fp, Gll^Fdf, Gll^Fp, Co, 4 Ko, Co, Rb, Rb, Rb, Rb, Gs, Ww, Wo, Ha, Hh, Mm, Gll^Fmf, Gll^Fmf, Gll^Fmf, Rb, Hh, Mm, Ms, Ms, Coa, 3 Koa, Coa, Aa^Fpa, Hh, Ha, Ms, Ha, Hh, Ha, Ha, Ha, Ms, Ha, Ha
Mm^Xm, Mm, Mm, Mm, Hh, Hh, Rb, Gll^Fmf, Rb, Rb, Rb, Co, Rb, Rb, Wo, Ww, Ww, Ww^Bw\, Rb, Gll^Fdf, Aa^Fda, Ms, Mm, Gll^Fdf, Rb, Rb, Hh, Hh^Vhh, Mm, Ha, Ha, Coa, Co, Coa, Rb, Rb, Rb, Ha^Vhha, Hh, Ha, Ms, Ms, Ms, Ha, Ha, Ha
Mm^Xm, Mm, Mm, Hh, Hh, Rb, Gs, Rb, Mm, Hh, Rb, Rb, Wo, Ww, Mm, Mm, Mm, Gs, Rb, Gll^Fdf, Mm, Mm, Ms, Aa^Fma, Rb, Aa, Hh, Mm, Hh, Ha, Aa^Vca, Gs, Rb, Rb, Ms, Ms, Ms, Aa^Fpa, Hh, Ms, Hh, Ms, Ha, Ha, Ms, Ms
Mm, Mm, Mm, Hh, Rb, Rb, Mm, Mm, Mm, Gll^Fp, Rb, Wo, Gs, Mm, Mm, Mm, Gs, Gs, Rb, Gs, Mm, Ms, Ms, Aa^Fpa, Rb, Hh, Mm, Mm, Gll^Fp, Gll^Fp, Aa, Rb, Hh, Ha, Hh, Ms, Ms, Ms, Ms, Ms, Ha, Ha, Ms, Ms, Ms, Ms^Xm
Hh, Mm, Hh, Gd^Vo, Gll^Fp, Gs, Mm, Mm, Hh, Hh^Vhh, Rb, Ww, Gs, Mm, Mm, Mm, Gs, Rb, Gs, Gs, Hh, Mm, Mm, Gs^Vc, Rb, Hh, Hh, Gll^Fmf, Rb, Rb, Rb, Rb, Gll^Fmf, Ha, Ms, Ms, Ms, Ms, Ms, Ms, Ha, Ms, Ha, Ms, Ms^Xm, Ms^Xm
Gll^Fp, Hh, Hh, Gll^Fp, Gs, Gs, Mm, Mm, Hh, Rb, Gll^Fp, Ww, Gs, Mm, Mm, Mm, Gs, Rb, Gs, Gs, Hh, Mm, Ms, Gll^Fp, Aa, Rb, Rb, Rb, Gll^Fp, Hh, Rb, Gll^Fp, Mm, Hh, Ha, Ms, Ms, Ms, Ha, Ha, Ha^Vhha, Aa, Aa, Ha, Ms^Xm, Ms^Xm
Gs, Gll^Fp, Gll^Fp, Gll^Fmf, Gs, Mm, Mm, Mm, Hh, Rb, Gll^Fdf, Ww, Gs, Mm, Mm, Mm, Gll^Fmf, Rb, Rb, Rb, Gd^Vo, Hh, Mm, Ha, Aa, Gs, Rb, Gll^Fmf, Hh, Gll^Fmf, Gll^Fmf, Rb, Hh, Hh, Gll^Fp, Aa^Fpa, Mm, Mm, Mm, Aa^Fpa, Rb, Aa, Aa^Fma, Ha, Ha, Ms^Xm
Gs, Gll^Fp, Gs, Gs, Gll^Fp, Mm, Mm, Mm, Hh, Rb, Ww, Ww, Gs, Mm, Mm, Gll^Fmf, Gll^Fmf, Gs, Rb, Gs, Hh, Hh, Mm, Mm, Gll^Fmf, Rb, Gs, Gll^Fmf, Mm, Gll^Fp, Gs, Rb, Rb, Rb, Aa, Gll^Fp, Hh, Mm, Ha, Gll^Fp, Rb, Aa^Fpa, Aa^Fma, Aa, Ms^Xm, Ms^Xm
Ww, Gs, Gs, Gll^Fdf, Gll^Fmf, Gs, Hh, Hh, Rb, Rb, Ww, Gs, Mm, Mm, Hh, Hh, Gll^Fmf, Rb, Gs, Gs, Hh, Mm, Mm, Mm, Gll^Fmf, Rb, Rb, Gd^Vo, Mm, Gs, Gll^Fmf, Mm, Gll^Fp, Hh, Aa^Fpa, Aa, Rb, Ha, Rb, Aa, Rb, Aa^Fpa, Aa^Fma, Aa^Fma, Aa^Fma, Ms^Xm
Gs, Ww, Ww, Ww, Ww, Gs, Gs, Rb, Gs, Gs, Ww, Gs, Mm, Mm, Hh, Hh, Hh^Vhh, Rb, Rb, Gs, Gs, Aa^Fpa, Gs, Gll^Fmf, Aa, Gs, Rb, Gll^Fp, Mm, Gs, Gll^Fp, Mm, Hh, Mm, Mm, Ha, Rb, Aa, Aa^Fpa, Ha, Aa, Rb, Aa, Aa^Fma, Ms^Xm, Ms^Xm
Gll^Fp, Gs, Gs, Gs, Hh, Ww, Ww, Ww^Bw|, Ww, Ww, Gs, Gs, Mm, Mm, Mm, Hh, Hh, Gll^Fmf, Gll^Fmf, Rb, Rb, Rb, Rb, Gs, Rb, Rb, Gll^Fmf, Mm, Mm, Gs, Gll^Fmf, Gll^Fp, Mm, Ms, Ms, Gll^Fp, Aa, Ha, Aa^Fpa, Ms, Aa^Voa, Rb, Mm, Mm, Ms^Xm, Ms^Xm
Gll^Fp, Gll^Fp, Gs, Gs, Hh, Gll^Fmf, Gll^Fmf, Rb, Rb, Ww, Ww, Gs, Mm, Mm, Mm, Mm, Mm, Hh, Gll^Fmf, Gll^Fmf, Mm, Gs^Vc, Ms, Rb, Rb, Gs, Gll^Fp, Mm, Gll^Fmf, Gs, Gs^Vc, Mm, Mm, Mm, Ms, Hh, Gll^Fp, Aa, Ha, Aa^Fpa, Mm, Mm, Mm, Mm, Ms^Xm, Ms^Xm
Gll^Fp, Gs, Gs, Gll^Fmf, Hh, Gll^Fp, Gll^Fp, Gs^Vc, Rb, Gs, Ww, Gs, Gs, Mm, Mm, Mm, Mm, Mm, Mm, Mm, Mm, Mm, Mm, Aa, Gs, Rb, Aa, Gll^Fp, Gs, Gs, Hh, Gll^Fmf, Hh, Gll^Fp, Ms, Gll^Fp, Rb, Rb, Aa^Fpa, Mm, Mm^Xm, Mm^Xm, Ha, Ha, Ms^Xm, Ms^Xm
Gs, Gs, Gll^Fp, Gll^Fmf, Mm, Hh, Hh, Gll^Fmf, Rb, Gs, Ww, Gs, Gs, Mm, Mm, Mm, Mm, Mm, Mm, Mm, Mm, Mm, Mm, Gs, Rb, Rb, Gs, Gs, Gs, Gs, Mm, Hh, Gll^Fp, Ha, Hh, Ha, Aa, Ha, Mm, Mm, Mm, Hh, Ha, Ha, Ms^Xm, Ms^Xm
Gs, Gs, Gll^Fp, Mm, Mm, Mm, Mm, Hh, Hh, Rb, Ww, Gs, Gs, Hh, Hh, Mm, Mm, Mm, Mm, Mm, Mm, Mm, Mm, Gs, Rb, Aa, Hh, Hh, Mm, Mm, Mm, Mm, Gll^Fp, Gll^Fmf, Aa, Gs, Rb, Hh^Vhh, Ms, Mm, Mm, Hh, Ha, Mm^Xm, Ms^Xm, Ms^Xm
Gll^Fp, Gll^Fmf, Gll^Fp, Hh, Mm, Mm, Gll^Fp, Mm, Mm, Rb, Rb, Ww, Ww^Bw/, Rb, Rb, Hh, Gd^Vo, Mm, Gs, Mm, Gs, Mm, Gs, Gs, Rb, Aa, Gs, Mm, Gs, Mm, Mm, Mm, Gll^Fmf, Aa, Rb, Rb, Ha, Ms, Ms, Ms, Ha, Aa, Aa^Vca, Ha, Ms^Xm, Ms^Xm
Gll^Fp, Gll^Fp, Gll^Fp, Hh, Mm, Mm, Gll^Fp, Gll^Fp, Gd^Vo, Mm, Hh, Rb, Gll^Fmf, Ww, Hh, Rb, Rb, Gs, Rb, Gs, Gs, Gs, Rb, Rb, Gs, Rb, Rb, Gs, Gs, Gs, Aa, Gll^Fp, Aa^Fpa, Rb, Aa, Ha, Ms, Ms, Ms, Ms, Aa, Aa, Rb, Ha, Ms^Xm, Ms^Xm
Gs, Gll^Fmf, Gll^Fmf, Mm, Mm, Mm, Mm, Rb, Rb, Gll^Fmf, Rb, Rb, Gll^Fp, Ww, Hh, Hh, Mm, Rb, Gs, Rb, Rb, Rb, Gs^Vc, Rb, Gs, Gs, Gs, Rb, Rb, Aa, Aa^Fpa, Gll^Fp, Aa^Fpa, Rb, Gs, Ha, Ms, Ms, Ha, Aa, Aa, Rb, Aa^Fpa, Ha, Ms^Xm, Ms^Xm
Gs, Gll^Fmf, Gll^Fmf, Hh, Mm, Mm, Mm, Hh, Mm, Rb, Rb, Gll^Fp, Gll^Fp, Ww, Ww, Mm, Mm, Mm, Mm, Gll^Fmf, Gll^Fp, Gll^Fmf, Rb, Rb, Gs, Aa, Aa, Gs, Gs, Rb, Rb, Gll^Fmf, Rb, Rb, Aa, Ha, Ha, Ha, Rb, Aa, Rb, Rb, Aa^Fma, Aa^Fpa, Ms^Xm, Ms^Xm
Gs, Gs, Gs, Gs, Hh, Mm, Mm, Mm, Mm, Mm, Gs, Rb, Rb, Gll^Fp, Gll^Fmf, Ww, Ww, Mm, Mm, Gll^Fmf, Mm, Gll^Fp, Gll^Fmf, Rb, Hh, Gs, Aa, Aa, Aa, Gs, Aa, Rb, Rb, Gs, Ha, Ha, Rb, Rb, Aa, Rb, Aa^Fpa, Aa, Ha, Aa^Fpa, Ha, Ms^Xm
Mm, Gs, Gs, Gs, Gs, Mm, Mm, Mm, Mm, Hh, Gs, Gs, Gs, Rb, Rb, Rb, Gs^Vc, Ww, Mm, Mm, Mm, Hh, Gll^Fmf, Rb, Gs, Gs, Gs, Aa, Aa, Gs, Gs, Aa, Gs, Rb, Rb, Rb, Ha, Ha, Aa^Vha, Aa, Aa^Fma, Ha, Ms, Ha, Ms, Ha
Mm, Mm, Mm, Gs, Gs, Gs, Gs, Mm, Mm, Hh, Gs, Gs, Gs, Rb, Gs, Gs, Ww, Ww, Mm, Mm, Mm, Gll^Fp, Gs, Rb, Aa, Aa, Gs, Ai, Wwg, Aa, Rb, Gs, Aa, Gs, Rb, Aa^Fpa, Aa, Ms, Aa, Ha, Ha, Ha, Ms, Ms, Ms, Ms
Mm, Mm, Mm, Mm, Gs, Gs, Gs, Mm, Mm, Mm, Gs, Gs, Gs, Rb, Gs, Ww, Mm, Mm, Mm, Mm, Mm, Mm, Gs, Rb, Aa, Aa, Wwg, Wwg, Wog, Wwg, Wwg, Ai, Ai, Aa, Aa, Rb, Rb, Aa, Rb, Aa, Aa, Ha, Aa^Fpa, Ms, Ms, Ms
Mm, Mm, Mm, Mm, Gs, Gs, Gs, Hh, Mm, Mm, Gs, Gs, Rb, Rb, Rb, Ww, Hh, Mm, Hh, Mm, Hh, Gll^Fdf, Rb, Rb, Gs, Rb, Wwg, Ww^Ewl, Wog, Wog, Wog, Wwg, Wwg, Wwg, Wwg, Aa, Aa, Rb, Cea, Cea, Cea, Aa, Aa^Fpa, Ha, Aa^Fpa, Ha
Mm, Mm, Mm, Mm, Gd^Vo, Gs, Gs, Hh, Hh, Gs, Rb, Rb, Gs, Gs, Ww, Ww^Bw\, Rb, Hh, Gll^Fdf, Hh, Rb, Rb, Gll^Fdf, Gs^Vc, Wwg, Wwg, Wog, Wog, Wwg, Wog, Wog, Wog, Wo, Wog, Ww^Vm, Ai, Aa, Rb, Cea, 1 Kea, Cea, Rb, Rb, Aa^Fma, Aa^Fma, Aa^Fma
Mm, Mm, Mm, Mm, Gll^Fp, Rb, Rb, Gs, Rb, Rb, Co, Gs, Gs, Ww, Gd^Vo, Gs, Rb, Gll^Fmf, Rb, Rb, Rb, Gll^Fdf, Rb, Wwg, Wog, Wog, Wog, Wwg, Gll^Fp, Ai, Wwg, Wwg, Ww, Wwg, Rb, Wwg, Ai, Aa, Aa, Cea, Rb, Rb, Aa^Fma, Rb, Rb, Aa^Fma
Mm, Mm, Mm, Gll^Fp, Gll^Fp, Gll^Fmf, Gll^Fmf, Rb, Gs, Co, 2 Ko, Co, Ww, Ww, Ww, Rb, Gs, Rb, Gs, Gs, Gs, Rb, Wwg, Wwg, Wog, Wog, Ww, Wwg, Gll^Fmf, Gll^Fmf, Gll^Fmf, Gll^Fp, Gll^Fmf, Gll^Fmf, Hh, Aa^Fma, Aa^Fma, Ai, Ww, Aa, Aa^Fma, Aa^Fma, Aa^Fma, Ha^Vhha, Aa^Fpa, Rb
Mm, Mm, Mm, Mm, Gll^Fp, Gll^Fmf, Gll^Fp, Rb, Gll^Fmf, Co, Co, Co, Ww, Wwg, Ww, Gll^Fp, Gll^Fdf, Gs, Gs, Gs, Rb, Rb, Wwg, Wog, Wog, Wog, Wwg, Ai, Gll^Fp, Gll^Fmf, Hh, Hh, Hh, Hh, Mm, Ha, Ha, Aa^Fpa, Aa^Fpa, Ai, Ww, Aa^Fpa, Aa^Fpa, Ha, Ha, Aa^Fpa
Mm, Mm, Mm, Mm, Mm, Gll^Fp, Hh, Rb, Rb, Rb, Rb, Gll^Fp, Wwg, Wwg, Wwg, Gll^Fp, Gll^Fp, Gs, Rb, Gs, Rb, Wwg, Wog, Wog, Wwg, Wwg, Ai, Ai, Gll^Fp, Gll^Fp, Hh, Hh, Mm, Mm, Mm, Ha, Ms, Ms, Ha, Aa^Fpa, Ww, Ha, Ms, Aa^Fpa, Ms, Ha
Mm, Mm, Mm, Mm, Mm, Mm, Mm, Hh, Mm, Ww, Wwg, Ww^Vm, Wog, Wog, Wog, Wwg, Wwg, Gll^Fdf, Wwg, Rb, Wwg, Wwg, Wo, Wwg, Gll^Fmf, Gll^Fp, Gll^Fmf, Gll^Fmf, Hh, Gll^Fp, Mm, Mm, Mm, Mm, Ms^Xm, Ms, Ms, Ms, Ww, Ai, Ms, Ms, Ms^Xm, Ms, Ms^Xm, Ms
Mm, Mm, Mm, Mm, Mm, Mm, Mm, Mm, Wwg, Wwg, Wog, Wog, Wog, Wog, Wog, Wog, Wwg, Wwg, Wwg, Wwg, Wwg, Wog, Wog, Ai, Gll^Fp, Gll^Fp, Hh, Hh, Hh, Mm, Mm, Mm, Ms^Xm, Ms^Xm, Ms^Xm, Ms^Xm, Ms^Xm, Ms^Xm, Ai, Ms, Ms^Xm, Ms^Xm, Ms^Xm, Ms^Xm, Ms^Xm, Ms^Xm
