Xu, Xu, Xu, Xu, Xu, Xu, Xu, Xu, Xu, Xu, Xu, Xu, Xu, Xu, Uu, Uu, Uu, Xu, Xu, Xu, Xu, Xu, Xu, Xu, Xu, Xu, Xu, Xu, Xu, Xu, Xu, Xu, Xu, Xu, Xu, Xu, Xu, Xu, Xu, Xu, Xu, Xu, Xu, Xu, Xu, Xu
Xu, Xu, Xu, Xu, Xu, Xu, Xu, Xu, Xu, Xu, Xu, Xu, Uu, Uu, Uu^Vud, Uu, Uu, Uu, Xu, Xu, Xu, Xu, Xu, Xu, Xu, Xu, Xu, Xu, Xu, Xu, Xu, Xu, Xu, Xu, Uu, Ur, Uu, Xu, Ur, Xu, Xu, Xu, Xu, Xu, Xu, Xu
Xu, Xu, Xu, Xu, Xu, Xu, Xu, Xu, Xu, Xu, Xu, Xu, Uu, Uu, Ur, Uu, Uu, Xu, Xu, Xu, Uu, Xu, Uu, Xu, Ur, Ur, Ur, Xu, Ur, Xu, Xu, Xu, Xu, Xu, Uu, Uu^Vud, Uu, Uu, Ur, Ur, Ur, Xu, Xu, Xu, Xu, Xu
Xu, Xu, Xu, Xu, Xu, Xu, Xu, Xu, Ur, Xu, Uu, Uu, Uu, Ur, Uu, Uu, Uu, Uu, Ur, Uu^Vu, Ur, Ur, Ur, Ur, Uu, Uu, Uu, Ur, Cud, Cud, Cud, Xu, Ur, Xu, Ur, Uu, Ur, Ur, Uu, Xu, Xu, Ur, Ur, Xu, Xu, Xu
Xu, Xu, Xu, Xu, Xu, Xu, Co, Co, Co, Ur, Uu, Uu, Uu, Ur, Ur, Ur, Ur, Ur, Uu^Uf, Ur, Uu, Ur, Xu, Xu, Xu, Xu, Xu, Ur, Cud, 3 Kud, Cud, Ur, Ur, Ur, Xu, Ur, Uu, Ur, Ur, Xu, Xu, Uu, Uu, Xu, Xu, Xu
Xu, Xu, Xu, Xu, Uu, Ur, Co, 2 Ko, Co, Ur, Ur, Ur, Ur, Ur, Xu, Ur, Ur, Uu, Uu, Uu, Uu, Uu, Xu, Xu, Uu, Uu^Vu, Uu, Ur, Ur, Cud, Ur, Ur, Uu, Uu, Uu, Xu, Xu, Uu, Uu, Ur, Rr^Vd, Uu, Uu, Uu, Xu, Xu
Xu, Xu, Xu, Uu, Uu, Ur, Ur, Co, Ur, Ur, Uu, Uu, Ql, Xu, Xu, Xu, Ur, Uu, Uu, Uu, Xu, Xu, Xu, Xu, Uu, Uu, Uu, Ur, Uu, Ur, Uu, Uu, Uu, Uu, Rr^Vd, Uu, Uu, Xu, Uu, Ur, Uu, Xu, Xu, Uu, Xu, Xu
Xu, Xu, Uu, Uu, Uu, Uu, Uu, Ur, Uu, Uu, Xu, Ql, Ql, Xu, Uu, Ur, Ur, Uu, Xu, Uu, Xu, Xu, Ur, Ur, Ur, Qlf, Ur, Ur, Uu, Uu, Xu, Uu, Xu, Uu, Uu, Uu, Uu, Xu, Ur, Ur, Ur, Xu, Xu, Xu, Xu, Xu
Xu, Xu, Uu, Uu, Uu, Uu, Ur, Ur, Uu, Xu, Xu, Xu, Ql, Ql, Uu, Ur, Ur, Uu, Ur, Ur, Ur, Uu, Xu, Ur, Uu, Ur, Xu, Xu, Xu, Xu, Xu, Xu, Xu, Xu, Qlf, Uu, Qlf, Uu, Ur, Ur, Ur, Uu, Xu, Xu, Xu, Xu
Xu, Xu, Xu, Uu, Uu, Uu, Ur, Uu^Vu, Ur, Xu, Uu, Xu, Uu, Uu, Uu, Ql, Ur, Ur, Uu, Ur, Xu, Xu, Xu, Xu, Ur, Ur, Xu, Xu, Xu, Xu, Xu, Xu, Xu, Xu, Xu, Qlf, Uu, Uu, Ur, Ur, Uu, Uu, Xu, Xu, Xu, Xu
Xu, Xu, Xu, Xu, Xu, Xu, Xu, Ur, Uu, Ur, Ur, Uu, Uu, Uu, Uu, Uu, Ur, Ur, Ur, Xu, Ur, Xu, Ur, Ur, Uu, Xu, Xu, Xu, Xu, Xu, Xu, Xu, Xu, Xu, Xu, Uu, Ur, Ur, Uu, Rr^Vd, Uu, Xu, Xu, Xu, Xu, Xu
Xu, Xu, Ur, Xu, Xu, Xu, Xu, Xu, Uu, Uu, Ur, Rr^Vd, Ur, Uu, Xu, Xu, Xu, Ur, Uu, Ur, Ur, Ur, Xu, Uu, Xu, Xu, Xu, Xu, Xu, Xu, Uu, Xu, Ur, Xu, Rr^Vd, Uu, Ur, Ur, Ur, Uu, Uu, Xu, Xu, Uu, Uu, Xu
Xu, Uu, Uu^Vu, Ur, Ur, Uu, Xu, Xu, Uu, Uu, Uu, Ur, Uu, Xu, Xu, Xu, Xu, Uu, Xu, Ur, Xu, Xu, Uu, Xu, Ur, Uu, Ur, Ur, Ur, Ur, Ur, Ur, Uu, Ur, Ur, Ur, Uu, Uu, Ur, Ur, Uu, Xu, Xu, Uu, Uu, Uu
Xu, Uu, Uu, Uu, Ur, Ur, Xu, Xu, Xu, Uu, Uu, Ur, Uu, Xu, Xu, Xu, Ur, Xu, Ur, Ur, Ur, Uu, Uu^Uf, Ur, Xu, Ur, Xu, Uu, Xu, Uu, Xu, Xu, Xu, Xu, Xu, Xu, Xu, Uu, Uu, Ur, Ur, Xu, Rr^Vd, Uu, Xu, Xu
Xu, Xu, Uu, Uu, Uu, Ur, Uu, Xu, Xu, Uu, Ur, Ur, Xu, Xu, Uu, Ur, Ur, Uu, Uu, Ur, Uu^Vud, Ur, Ur, Ur, Uu, Xu, Xu, Xu, Xu, Xu, Xu, Xu, Xu, Xu, Xu, Xu, Xu, Xu, Xu, Uu, Uu, Ur, Ur, Uu, Xu, Xu
Xu, Xu, Uu, Rr^Vd, Qlf, Ur, Uu, Xu, Xu, Ur, Uu, Uu, Ur, Uu, Ur, Ur, Uu, Ur, Xue, Ur, Ur, Ur, Uu, Uu, Wog, Xu, Wog, Wog, Wog, Wog, Wog, Wog, Wog, Wog, Wog, Xu, Xu, Xu, Xu, Uu, Ur, Ur, Ur, Ur, Xu, Xu
Xu, Xu, Ur, Uu, Qlf, Ur, Ur, Uu, Ur, Ur, Ur, Ur, Ur, Ur, Uu, Uu, Xue, Xue, Uu, Ur, Ur, Ur, Wog, Wog, Wog, Wog, Wog, Wog, Wog, Wog, Wog, Wog, Wog, Wog, Wog, Xu, Uu, Xu, Uu, Uu^Uf, Ur, Uu, Uu, Ur, Uu, Xu
Xu, Xu, Xu, Uu, Qlf, Qlf, Uu, Ur, Uu, Uu, Ur, Uu, Uu^Vud, Uu, Qlf, Qlf, Xue, Uu, Uu, Ur, Uu, Ur, Wog^Bsb\, Wog, Wog, Wog, Wog, Wog, Wog, Wog, Wog, Wog, Wog, Wog, Wog, Wog, Uu, Uu, Ur, Ur, Xu, Uu, Ur, Ur, Uu, Xu
Xu, Xu, Xu, Qlf, Qlf, Qlf, Uu, Uu, Ur, Ur, Xu, Uu, Uu, Uu, Qlf, Uu, Xue, Uu, Ur, Ur, Ur, Wog, Wog, Wog^Bsb\, Wog^Bsb\, Wog, Ur, Uu, Ur, Uu, Uu, Wog, Wog, Wog, Wog, Wog, Wog, Uu, Ur, Uu, Xu, Uu, Uu, Uu^Uf, Uu, Xu
Xu, Xu, Xu, Xu, Qlf, Qlf, Uu, Uu, Ur, Xu, Xu, Uu, Uu, Qlf, Uu, Xue, Xue, Uu^Uf, Uu, Uu, Wog, Wog^Bsb\, Wog^Bsb\, Wog, Uu, Ur, Ur, Ur, Ql, Ur, Uu, Uu, Uu, Uu, Wog, Wog, Wog, Uu^Vu, Uu, Ur, Xu, Xu, Uu, Ur, Xu, Xu
Xu, Xu, Xu, Xu, Qlf, Qlf, Uu, Uu^Vu, Uu, Ur, Ur, Uu, Uu, Uu, Xu, Xue, Xu, Uu, Uu, Rr^Vd, Wog, Wog, Wog, Wog^Bsb\, Ur, Uu, Ur, Uu, Uu, Ur, Ur, Uu, Wog, Uu, Wog, Wog, Wog, Uu, Ur, Ur, Rr^Vd, Xu, Ur, Ur, Xu, Xuce
Xu, Xu, Xu, Xu, Xu, Qlf, Uu, Xu, Xu, Xu, Ur, Uu, Xu, Xu, Xu, Xue, Xu, Xu, Xu, Uu, Wog, Wog, Wog, Uu, Ur, Ur, Ql, Ur, Ur, Ur, Ur, Uu, Wog, Wog, Wog, Wog, Wog, Uu, Ur, Uu, Uu, Xu, Uu, Ur, Xu, Xuce
Xu, Xu, Xu, Xu, Xu, Qlf, Uu, Uu, Xu, Ur, Ur, Uu, Xu, Xu, Xu, Xue, Xu, Xu, Xu, Xu, Wog, Wog, Wog, Uu, Ur, Ql, Uu, Ql, Ur, Ur, Uu, Ur, Wog^Bsb\, Wog, Wog, Wog, Wog, Uu, Ur, Uu, Uu, Xu, Ur, Ur, Xu, Xu
Xu, Xu, Xu, Xu, Xu, Xu, Xu, Uu, Ur, Ur, Ql, Uu, Uu, Xu, Xu, Xu, Xu, Xu, Xu, Xu, Wog, Wog, Wog, Uu, Uu, Ur, Ur, Ql, Ur, Ur, Ur, Wog, Wog, Wog^Bsb\, Wog^Bsb\, Wog, Uu, Ur, Uu^Uf, Uu, Xu, Xu, Ur, Uu, Uu, Xu
Xu, Xu, Xu, Xu, Xu, Xu, Xu, Uu, Ur, Ql, Ql, Uu, Uu, Xu, Xu, Xue, Xu, Xu, Xu, Xu, Wog, Wog, Wog, Wog, Wog, Uu, Wog, Ur, Wog, Wog, Wog, Wog^Bsb\, Wog^Bsb\, Wog, Wog, Ur, Ur, Ur, Uu, Xu, Xu, Uu, Uu, Ur, Uu, Xu
Xu, Xu, Xu, Xu, Xu, Xu, Xu, Xu, Ur, Uu, Ur, Uu, Uu, Uu, Xu, Xue, Xue, Xu, Xu, Xu, Xu, Wog, Wog, Wog, Wog, Wog, Wog, Wog, Wog, Wog, Wog, Wog, Wog, Wog^Bsb\, Ur, Ur, Ur, Uu, Xu, Xu, Uu, Uu, Uu^Vud, Uu, Xu, Xu
Xu, Xu, Xu, Xu, Xu, Xu, Xu, Xu, Xu, Ur, Ur, Ur, Uu, Uu, Xu, Xu, Xue, Xu, Xu, Xu, Xu, Wog, Wog, Wog, Wog, Wog, Wog, Wog, Wog, Wog, Uu, Wog, Ur, Wog, Ur, Uu, Ur, Ur, Ur, Xu, Uu, Ur, Uu, Xu, Xu, Xuce
Xu, Xu, Xu, Xu, Xu, Xu, Xu, Xu, Xu, Xu, Ur, Ur, Uu, Uu, Uu, Xu, Xu, Xue, Xue, Xu, Xu, Xu, Xu, Xu, Xu, Wog, Wog, Wog, Uu, Uu, Ur, Ur, Uu, Ur, Ur, Ur, Ur, Ur, Ur, Ur, Ur, Ur, Uu, Xu, Xu, Xu
Xu, Xu, Xu, Xu, Xu, Xu, Xu, Xu, Xu, Xu, Xu, Ur, Ur, Uu, Uu, Uu, Uu, Xu, Uu, Xue, Xue, Xue, Xue, Xu, Xu, Xu, Xu, Uu, Uu, Uu, Ur, Uu^Uf, Xu, Uu, Rb, Ur, Rb, Ur, Rb, Ur, Ur, Uu, Uu, Xu, Xu, Xu
Xu, Xu, Xu, Xu, Xu, Xu, Xu, Xu, Xu, Xu, Xu, Ur, Ur, Ur, Ur, Rr^Vd, Uu, Uu, Ur, Uu, Uu, Uu, Uu, Xue, Xue, Xue, Xue, Uu, Xue, Uu, Ur, Ur, Xu, Xu, Re, Re, Ce, Rb, Re, Xu, Xu, Ur, Xu, Xu, Xu, Xu
Xu, Xu, Xu, Xu, Xu, Xu, Xu, Xu, Xu, Xu, Xu, Xu, Xu, Ur, Xu, Ur, Ur, Ur, Uu, Ur, Ur, Ur, Ur, Uu, Ur, Uu, Uu, Xue, Ur, Ur, Ur, Ur, Xu, Gd, Gd, Ce, 1 Ke, Ce, Gd, Rb^Emf, Xu, Xu, Xu, Xu, Xu, Xu
Xu, Xu, Xu, Xu, Xu, Xu, Xu, Xu, Xu, Xu, Xu, Xu, Xu, Xu, Xu, Xu, Xu, Xu, Xu, Xu, Xu, Xu, Ur, Ur, Uu, Ur, Ur, Ur, Uu, Uu, Ur, Ur, Xu, Gs, Gs, Ce, Ce, Ce, Gs, Gd, Xu, Xu, Xu, Xu, Xu, Xu
Xu, Xu, Xu, Xu, Xu, Xu, Xu, Xu, Xu, Xu, Xu, Xu, Xu, Xu, Xu, Xu, Xu, Xu, Xu, Xu, Xu, Xu, Xu, Uu, Uu, Uu^Vud, Uu, Ur, Ur, Uu^Vu, Xu, Xu, Xu, Gs, Gs, Rb, Rb, Rb, Gs, Xu, Xu, Xu, Xu, Xu, Xu, Xu
Xu, Xu, Xu, Xu, Xu, Xu, Xu, Xu, Xu, Xu, Xu, Xu, Xu, Xu, Xu, Xu, Xu, Xu, Xu, Xu, Xu, Xu, Xu, Xu, Xu, Xu, Xu, Xu, Xu, Xu, Xu, Xu, Xu, Xu, Xu, Gs, Rb, Rb, Gg, Gg, Xu, Xu, Xu, Xu, Xu, Xu
Xu, Xu, Xu, Xu, Xu, Xu, Xu, Xu, Xu, Xu, Xu, Xu, Xu, Xu, Xu, Xu, Xu, Xu, Xu, Xu, Xu, Xu, Xu, Xu, Xu, Xu, Xu, Xu, Xu, Xu, Xu, Xu, Xu, Xu, Xu, Gg, Ur, Rb, Rb, Gll^Edp, Xu, Xu, Xu, Xu, Xu, Xu
