Rb^Edb, Rb^Edb, Rb^Edb, Rb^Edb, Rb^Edb, Rb^Edb, Rb^Edb, Rb^Edb, Rb^Edb, Rb^Edb, Rb^Edb, Uu, Uu, Uu, Uu, Uu, Uu, Uu, Uu, Uu, Uu, Uu, Uu, Ur, Uu, Rb^Edb, Uu, Uu, Uu, Uu, Uu, Uu, Uu, Rb^Edb, Rb^Edb, Rb^Edb, Xue, Xue, Xue, Xue, Rb^Es, Xue, Uh, Xue, Xue, Xue
Rb^Edb, Rb^Edb, Rb^Edb, Rb^Edb, Rb^Edb, Rb^Edb, Rb^Edb, Rb^Edb, Rb^Edb, Rb^Edb, Rb^Edb, Rb^Edb, Rb^Edb, Uu, Rb^Edb, Uu, Uu, Uu, Uu, Uu, Uu, Uu, Uu, Uu, Cud^Edb, Uu, Uu, Uu, Uu, Uu, Rb^Edb, Uu, Rb^Edb, Rb^Edb, Xue, Xue, Rb^Edb, Rb^Edb, Rb^Es, Rb^Es, Rb^Es, Uh, Xue, Uh, Uh, Xue
Rb^Edb, Rb^Edb, Rb^Edb, Rb^Edb, Rb, Rb^Edb, Rb, Rb^Edb, Ur, Rb^Edb, Rb^Br/, Rb^Edb, Rb^Br/, Rb^Edb, Rb^Edb, Uu, Rb^Edb, Uu, Uu, Uu, Uu, Uu, Cud^Edb, Cud^Edb, 2 Kud^Edb, Cud^Edb, Cud^Edb, Uu, Uu, Rb^Edb, Rb^Edb, Rb^Edb, Rb^Edb, Xue, Rb^Edb, Rb^Edb, Xue, Rb^Edb, Rb^Es, Rb^Es, Rb^Es, Xuce, Xuce, Xuce, Xue, Xue
Rb^Edb, Rb^Edb, Rb, Rb, Cud^Edb, Rb, Rb, Rb, Rb^Br|, Rb^Br/, Rb^Edb, Rb^Br\, Rb^Edb, Rb^Br\, Rb^Br/, Rb^Br/, Rb^Br\, Rb^Br/, Rb^Br\, Uu, Uu, Uu, Uu^Br/, Cud^Edb, Cud^Edb, Cud^Edb, Uu, Uu^Vud, Rb^Edb, Rb^Edb, Rb^Edb, Rb^Edb, Rb^Edb, Rb^Edb, Xu, Xue, Rb^Edb, Rb^Es, Xuce, Xue, Xuce, Ur^Es, Ur^Es, Uu^Es, Uu^Es, Xue
Rb^Edb, Rb, Cud^Edb, Cud^Edb, 3 Kud^Edb, Cud^Edb, Cud, Uu^Vud, Rb^Br|, Rb^Edb, Rb^Edb, Rb^Edb, Rb^Edb, Rb^Edb, Uu, Uu, Uu, Uu, Uu, Rb^Br\, Rb^Br\, Rb^Br/, Uu, Uu, Uu, Uu, Rb^Edb, Rb^Edb, Xu, Rb^Edb, Xu, Xu, Xu, Rb^Edb, Xu, Xu, Uh, Xue, Uh, Xue, Xuce, Uu, Ce, Ce, 4 Ke, Uu^Es
Rb^Edb, Rb, Uu^Vud, Cud^Edb, Cud^Edb, Cud^Edb, Rb, Rb, Rb^Br/, Rb^Edb, Xu, Xu, Xu, Xu, Xu, Xu, Xu, Xu, Xu, Xu, Xu, Xu, Xu, Xu, Xu^Edb, Rb^Edb, Rb^Edb, Xu, Rb^Edb, Rb^Edb, Xu, Uu^Vu, Xu, Rb^Edb, Xu, Xu, Uh, Uh, Xuce, Xuce, Uu^Es, Uu^Es, Ce, Ce, Ce, Uu^Es
Rb^Edb, Rb, Rb, Rb, Rb, Rb, Rb^Br/, Rb^Br/, Rb^Edb, Rb^Edb, Xu, Xu, Xu, Xu, Rb^Edb, Xu, Rb^Edb, Xu, Ql, Xu, Rb^Edb, Xu, Qlf, Qlf, Ql, Xu^Edb, Xu^Edb, Rb^Edb, Rb^Edb, Xu, Rb^Edb, Rb^Edb, Xu, Rb^Edb, Rb^Edb, Xu, Xuc, Xue, Xuc, Rb^Dr, Ur^Es, Ur^Es, Re^Vct, Ce, Uu^Es, Uu^Es
Rb, Rb, Rb, Rb, Rb^Br/, Rb^Br/, Rb^Edb, Rb^Edb, Rb^Edb, Rb^Edb, Xu, Xu, Rb^Edb, Rb^Edb, Rb^Edb, Rb^Edb, Rb^Edb, Rb^Edb, Ql, Rb^Edb, Rb^Edb, Rb^Edb, Rb^Edb, Qlf, Ql, Qxu, Qxu, Xu^Edb, Rb^Edb, Rb^Edb, Rb^Edb, Xu, Rb^Edb, Xu, Rb^Edb, Xuc, Re^Vct, Xuc, Ur^Es, Ur^Es, Xuce, Xuce, Rb^Es, Rb^Ecf, Uu^Es, Rb^Es
Rb^Edb, Rb, Rb, Rb, Rb^Br|, Rb^Edb, Xu^Edb, Rb^Edb, Rb^Edb, Xu, Rb^Edb, Rb^Edb, Rb^Edb, Rb^Edb, Rb^Edb, Rb^Edb, Qxu, Qxu^Bp\, Qxu^Bp\, Ql, Qxu^Edb, Rb^Edb, Rb^Edb, Rb^Edb, Ql, Ql, Qxu, Xu^Edb, Rb^Edb, Xu, Rb^Edb, Rb^Edb, Rb^Edb, Xu, Rb^Edb, Xuc, Ur, Ur, Xuce, Xuce, Uh, Re^Vct, Rb, Rb^Emf, Re^Vct, Rb^Es
Rb^Edb, Rb^Edb, Rb^Edb, Rb, Rb^Br|, Rb^Edb, Rb^Edb, Xu^Edb, Rb^Edb, Rb^Edb, Rb^Edb, Rb^Edb, Rb^Edb, Rb^Edb, Qxu, Qxu, Rb^Edb, Qxu, Rb^Edb, Qxu^Bp\, Rb^Edb, Qxu^Bs/, Qxu, Uu^Edb, Rb^Edb, Rb^Edb, Rb^Edb, Rb^Em, Ql, Xu, Xu, Xu, Rb^Edb, Rb^Edb, Xu, Xu, Qxu^Bp|, Xuce, Xue, Uh, Rb, Rb, Rb, Rb, Mv^Edb, Rb^Es
Rb, Rb^Edb, Rb^Edb, Rb, Rb^Br|, Rb^Edb, Rb^Edb, Xu^Edb, Xu^Edb, Rb^Edb, Qxu^Bcx\, Qlf^Edb, Rb^Edb, Rb^Edb, Rb^Edb, Rb^Edb, Ql^Edb, Rb^Edb, Ql, Rb^Edb, Rb^Edb, Rb^Edb, Qxu, Rb^Edb, Rb^Edb, Uu^Vud, Rb^Edb, Rb^Edb, Rb^Edb, Xu, Xu, Rb^Edb, Xu, Xu, Xu, Ql, Qxu^Bp|, Qlf, Uh, Uh, Rb, Rb, Rb, Md, Mm, Md
Rb^Edb, Rb^Edb, Rb^Edb, Rb, Rb^Br|, Rb^Edb, Ql, Xu, Qlf^Edb, Qlf^Edb, Qlf^Edb, Qxu^Bcx\, Rb^Edb, Rb^Edb, Rb^Edb, Qxu^Edb, Ql^Edb, Ql^Edb, Ql^Edb, Qxu^Bcx/, Ql^Edb, Rb^Edb, Rb^Edb, Rb^Edb, Rb^Es, Rb^Edb, Mm^Edb, Mv^Edb, Mm^Edb, Rb^Edb, Xu, Rb^Edb, Uu^Vud, Xu, Xu, Qlf, Ur, Qlf, Md, Mv^Edb, Mm, Rb, Rb, Rb, Uh, Rb
Rb^Edb, Rb^Edb, Mv, Ql, Rb^Br|, Ql, Ql, Ql, Qlf^Edb, Qlf^Edb, Qlf^Edb, Qlf^Edb, Qlf^Edb, Rb^Edb, Qxu, Qxu, Qxu^Bcx/, Ql^Edb, Ql^Edb, Ql^Edb, Qxu, Ql, Rb^Edb, Uu^Vud, Ql, Rb^Edb, Mv^Edb, Mm^Edb, Mv^Edb, Rb^Edb, Xu, Rb^Edb, Rb^Edb, Xu, Xu, Re^Vct, Ur^Em, Xuce, Xuc, Md, Uh, Rb, Rb, Rb, Rb, Rb
Rb^Edb, Md, Md, Md, Rb^Br|, Ql, Xu^Edb, Xu, Rb^Edb, Rb^Edp, Rb^Edb, Qlf^Edb, Qlf^Edb, Rb^Edb, Rb^Edb, Ur^Edb, Qxu, Ql^Edb, Rb^Edb, Ql, Qxu, Ql, Rb^Edb, Rb^Edb, Uu^Vud, Rb^Edb, Rb^Edb, Mv^Edb, Rb^Edb, Rb^Edb, Rb^Edb, Rb^Edb, Rb^Edb, Xu, Uh, Xu, Xuc, Xuc, Uh, Xuc, Xue, Uh, Rb, Rb, Rb, Rb
Rb, Qlf, Qlf, Mv, Rb^Br|, Rb^Edb, Xu^Edb, Rb^Edb, Rb^Edb, Rb^Edb, Rb^Edb, Qlf^Edb, Qlf^Edb, Rb^Edb, Rb^Es, Qxu, Qxu, Qxu, Qxu, Rb^Edb, Rb^Edb, Qxu, Rb^Edb, Rb^Es, Rb^Edb, Rb^Edb, Uu^Vud, Rb^Edb, Rb^Edb, Ql, Xu, Rb^Edb, Rb^Edb, Uh, Xuce, Uh, Uh, Uh, Xue, Xue, Uu, Uu^Edb, Uu, Uu, Uu, Rb
Rb, Ql, Ql, Ql, Rb^Br|, Rb^Edb, Xu, Rb^Edb, Rb, Rb, Rb, Rb^Edb, Rb^Edb, Qlf^Edb, Rb^Es, Rb^Es, Rb^Edp, Qxu, Rb^Edb, Rb^Edb, Uu^Vud, Rb^Edb, Rb^Edb, Rb^Edb, Rb^Edb, Rb^Edb, Rb^Es, Rb^Edb, Rb^Es, Rb^Edb, Xu, Rb^Edb, Rb^Edb, Xue, Xue, Xue, Xue, Xue, Uu^Vud, Uu, Uu^Edb, Uu, Uu, Uu, Rb, Rb
Rb^Edb, Rb^Edb, Rb^Edb, Rb, Rb^Br|, Rb^Edb, Rb^Edb, Xu, Xu, Rb, Rb, Rb, Rb^Edb, Qlf^Edb, Qxu^Bcx/, Rb^Es, Rb^Edb, Rb^Edb, Rb^Edb, Rb^Edb, Rb^Edb, Rb^Edb, Rb^Es, Uu^Vu, Rb^Edp, Rb^Es, Rb^Es, Rb^Es, Xu, Xu, Rb^Edb, Rb^Edb, Rb^Edb, Qxe, Qxe, Rb, Uu^Edb, Uu, Uu^Edb, Uu^Edb, Uu^Edb, Uu^Edb, Rb^Eff, Rb^Eff, Rb^Eff, Rb^Eff
Rb^Edb, Rb^Edb, Rb^Edb, Rb^Edb, Rb^Br|, Rb^Edb, Rb^Edb, Rb^Edb, Xu, Rb, Rb, Rb, Rb, Rb, Rb, Qlf^Edb, Qlf^Edb, Rb^Edb, Rb^Edb, Rb^Edb, Rb^Es, Rb^Es, Rb^Es, Rb^Es, Rb^Edb, Rb^Edb, Xu, Xu, Xu, Xu, Rb^Edb, Rb^Edb, Qxe, Qxe, Uu, Uu, Uu^Edb, Uu^Edb, Rb^Edb, Uu^Edb, Rb^Eff, Rb^Eff, Uu^Vud, Gd^Ii, Gd^Ii, Rb
Rb, Rb^Edb, Rb^Edb, Rb^Edb, Rb^Br\, Rb^Edb, Rb^Edp, Rb^Edb, Rb^Edb, Xu, Rb, Rb, Co, Rb, Rb, Qlf^Edb, Qlf^Edb, Qlf^Edb, Qlf^Edb, Rb^Edb, Qlf^Edb, Rb^Edb, Rb^Edb, Rb^Edp, Xu, Xu, Xu, Xu, Rb^Edb, Rb^Edb, Qxe, Qxe, Qxu, Uu^Vud, Rb, Uu, Rb, Rb, Rb^Eff, Rb^Eff, Uu, Uu, Rb, Gll^Ii, Gll^Ii, Rb
Rb, Rb^Edb, Rb^Edb, Rb^Edb, Rb, Rb^Br\, Rb^Br\, Rb^Edb, Rb^Edb, Xu, Co, Co, 5 Ko^Edb, Co, Co, Rb, Rb, Qlf^Edb, Qlf^Edb, Qlf^Edb, Xu, Qlf^Edb, Xu, Xu, Rb^Edb, Rb^Edb, Rb^Edb, Rb^Edb, Qxu^Bp\, Qxe, Qxu, Qxu, Qxe, Rb, Uu, Uu, Rb^Eff, Rb^Eff, Rb, Uu, Uu, Uu, Uu, Uu, Rb, Rb
Rb^Edb, Rb^Edb, Rb^Edb, Rb^Edb, Rb^Edb, Rb, Rb^Edb, Rb^Br\, Rb^Br\, Rb^Edb, Rb^Edb, Co, Co, Co, Rb, Xu, Rb, Xu, Xu, Xu, Rb^Edb, Xu, Rb^Edb, Rb^Edb, Rb^Edb, Rb^Edb, Qxe, Qxe, Qxu, Qxu^Bp\, Qxu^Bp\, Qxe, Rb, Rb, Rb^Eff, Rb^Eff, Rb^Es, Rb^Es, Rb, Uu, Uu, Rb, Uh, Rb, Rb, Rb
Rb^Edb, Rb^Edb, Ww^Ewl, Ww^Vm, Rb^Edb, Rb^Edb, Rb^Edb, Rb, Rb, Rb^Br\, Rb^Br\, Rb^Br/, Rb, Rb, Rb, Rb, Rb, Rb, Xu, Rb^Edb, Rb^Edb, Rb^Edb, Rb^Edb, Rb^Edb, Rb^Edb, Rb^Edb, Rb^Edb, Qxu, Qxe, Qxe, Rb^Edp, Qxu^Bp\, Rb^Eff, Rb^Eff, Rb^Es, Rb, Uh, Rb, Uh, Uh, Uh, Uh, Uh, Uh, Uh, Rb
Ww^Ewl, Ww^Ewl, Ss, Ss^Bw/r, Ss^Vhs, Rb^Edb, Rb, Uh, Uh, Uh, Uh, Rb, Rb, Rb, Rb, Rb^Br|, Xu, Xu, Xu, Xu, Xu, Rb^Edb, Xu, Xu, Xu, Rb^Edb, Rb^Edb, Rb^Edb, Xu, Rb, Rb^Eff, Rb^Eff, Uu, Rb, Rb, Uh, Uh, Uh, Uh, Uh, Uh, Uh, Uh, Uh, Rr^Vhc, Rb
Xol, Ss, Ss^Vhs, Ww^Ewf, Ss, Ww^Ewl, Rp^Vhcr, Uh, Uh, Uh, Uh, Uh, Rp^Vhcr, Rb, Rb^Eff, Rb^Br|, Xu, Xu, Xu, Xu, Xu, Xu, Xu, Xu, Xu, Xu, Xu, Xu, Xu, Xu, Rb, Rb, Rb, Rb, Uu^Vud, Uh, Uh, Uh, Uh, Uh, Uh, Uh, Uu^Uf, Uh^Ecf, Re^Emf, Re^Emf
Xoc, Xol, Ss, Ss, Chs, Wwg, Wwg, Rp, Rp, Uh, Rp, Rp, Rp, Rb^Eff, Rb^Br/, Rb^Br\, Rb^Br/, Rb^Br\, Rb^Br\, Rb^Br/, Rb^Br\, Xu, Rb^Br/, Xu, Xu, Xu, Xu, Xu, Rb, Rb, Xu, Rb, Rb^Es, Rb, Uh, Uh, Uh, Uh, Uh, Uh, Uh, Uh, Rb^Edt, Re^Emf, Re^Emf, Re^Emf
Xoc, Xol, Chs, Chs, 6 Khs, Chr, Chr, Wog^Bsb/, Wwg, Rp, Uh, Uh, Rb^Br/, Rp^Br/, Rp, Rb^Eff, Rb^Eff, Xu, Xu, Xu, Xu, Rb^Br\, Xu, Rb^Br\, Rb^Br\, Xu, Xu, Rb, Uu^Vud, Xu, Xu, Rb, Uu, Rb^Edp, Rb, Uh, Uu, Uh, Qxu^Bw|, Uu, Uu, Uu, Uu^Em, Rb^Edt, Uu^Uf, Uu^Em
Xoc, Xoc, Xoc, Chs, Chr, Chr, Rp^Vhcr, Rp, Uh^Dr, Wwg, Uh^Br/, Uh^Br/, Uh, Rb, Rp, Rb^Edp, Rb^Eff, Rb^Eff, Xu, Xu, Xu, Xu, Xu, Xu, Rb^Eff, Rb^Eff, Uu, Rb, Uu, Xu, Qxe, Rb, Rb, Uu, Uu, Uu, Qxu, Uu^Vud, Qxu^Bw|, Uu^Vud, Qxu, Uu, Uu, Uu, Uu, Rb
Xoc, Xoc, Xoc, Xoc, Xoc, Wwg, Wwg, Uh^Edb, Uh^Br/, Rb^Br/, Uh^Edb, Rp^Vhcr, Rp, Rp, Uh, Uh^Eff, Rb^Eff, Rb^Edb, Xu, Xu, Xu, Xu, Xu, Xu, Uu, Uu, Uu, Uu, Aa, Qxu^Bh\, Qxu^Bh\, Rb, Rb, Rb, Uu^Vud, Qxu^Bw\r, Qxu^Bw\r, Qxu, Cud, Qxu, Qxu^Bw/, Qxu^Bw/, Uu^Vud, Aa, Aa^Edt, Rb
Xoc, Xoc, Xoc, Xoc, Xoc, Xoc, Xoc, Uh^Br/, Uh, Uh, Rp, Rp, Uh^Edb, Uh^Edb, Uh^Edb, Rb^Dr, Rb^Eff, Rb^Eff, Xu, Xu, Xu, Xu, Rb, Rb, Xu, Xu, Uu, Aa, Aa, Qxe, Wwrg, Aa, Uu^Ii, Rb^Ecf, Xue, Qxu, Cud, Cud, 1 Kud, Cud, Cud, Qxu, Xue, Aa, Ha^Vhha, Rb
Xoc, Xoc, Xoc, Xoc, Xoc, Xoc, Xoc, Xoc, Uh^Edb, Rp^Vhcr, Uh, Rp, Rp, Uh^Edb, Uh, Rb^Edb, Rb^Edb, Rb^Eff, Rb^Eff, Xu, Xu, Xu, Rb, Xu, Xu, Xu, Xu, Xu, Xu, Ai^Es, Aa^Es, Ai, Xue, Xue, Uue, Uue, Uue, Cud, Cud, Cud, Uue, Uue, Uue, Xue, Xue, Rb
Xoc, Xoc, Xoc, Xoc, Xoc, Xoc, Xoc, Xol, Rb, Uh, Rp, Rp, Uh^Edb, Rp, Rp^Vhcr, Rb, Rb^Edb, Rb^Edb, Rb^Edb, Rb^Eff, Rb^Eff, Rb, Co, Ket, Coa, Xu, Xu, Xu, Xu, Aa^Es, Aa^Es, Aa, Aa, Xue, Xue, Uue, Uue, Uue, Uue, Uue, Uue, Uue, Uue, Uue, Xue, Xue
Xoc, Xoc, Xoc, Xoc, Xoc, Xoc, Xoc, Xol, Rb, Rp^Vhcr, Uh, Uh, Uh^Edb, Uh, Uh, Uh, Rb^Edb, Rb^Edb, Rb^Edp, Rb^Edb, Rb^Eff, Rb^Eff, Aa, Coa, Aa, Ai, Xu, Xu, Aa, Aa, Aa^Voa, Aa, Aa, Xue, Xos, Xue, Uue, Uue, Uue, Uue, Uue, Uue, Uue, Uue, Uue, Xue
Xoc, Xoc, Xoc, Xoc, Xoc, Xoc, Xoc, Xol, Uh^Edb, Uh, Uh^Edb, Rb, Rb, Uh^Edb, Uh^Edb, Uh^Edb, Rb^Edb, Rb^Edb, Rb^Edb, Rb^Edb, Rb^Eff, Rb^Eff, Rrc^Vhca, Aa, Ha^Vhha, Aa, Aa, Aa^Voa, Aa, Aa, Aa, Aa, Xue, Xos, Xos, Xue, Xue, Xue, Uue, Uue, Uue, Uue, Xue, Xue, Xue, Xue
Xoc, Xoc, Xoc, Xoc, Xoc, Xoc, Xoc, Xol, Xoc, Uh^Edb, Xoc, Uh, Uh, Uh, Rb, Uh, Rb, Rb^Edb, Rb, Rb^Edb, Rb^Eff, Rb^Eff, Rb, Aa, Aa, Aa, Rrc^Vhca, Aa, Aa, Aa, Xue, Xue, Xue, Xos, Xue, Xue, Xue, Xue, Uue, Uue, Uue, Uue, Xue, Xue, Xos, Xos
Xoc, Xoc, Xoc, Xoc, Xoc, Xoc, Xoc, Xoc, Xoc, Xoc, Xoc, Uh, Rb, Rb, Rb, Rb, Rb, Rb, Rb, Rb, Rb^Eff, Rb^Eff, Rb, Rb, Rb, Aa, Aa, Aa, Aa, Xue, Xu, Xue, Xu, Xue, Xos, Xue, Xos, Xue, Xue, Uue, Uue, Xue, Xue, Xue, Xue, Xue
