border_size=1
usage=map

Wwt, Wwt, Wwt, Gs^Fds, Wwf, Gs^Fds, Gs^Fds, Gs^Fds, Gs^Fds, Gs^Fds, Gs^Fds, Gs^Fds, Gs^Fds, Gs^Fds, Gll^Fdw, Gs, Cv^Edb, Gs, Cv^Edb, Gs, Gs^Ecf, Gs, Gll^Fdw, Gs, Gd^Vo, Gs, Gs, Gs, Gs, Gs, Gs, Gs, Gd^Fts, Rd, Rd, Rd, Rd, Rd, Rd, Rd, Rd, Rd, Rd, Rd, Rd, Rd
Wwt, Wwt, Wwt, Wwf, Wwf, Gs^Fds, Wwf, Wwf, Wwf, Gs^Fds, Gs^Fds, Gs^Fds, Gs^Fds, Gll^Fdw, Gs^Ecf, Cv^Edb, Kv^Edb, Cv^Edb, Cv^Edb, Cv^Edb, Gd^Fetd, Gll^Fdw, Gll^Fdw, Gll^Fdw, Gll^Fdw, Gll^Fdw, Gll^Fdw, Gs, Gs, Gs, Gd^Fts, Gd^Fts, Gd^Fts, Rd^Edt, Rd^Edt, Rd^Edb, Rd^Ecf, Gll^Fdw, Co, Co, Co, Rd^Ecf, Rd, Re^Vct, Rd, Rd
Gg, Wwt, Wwt, Wwt, Wwt, Wwt, Wwt, Wwt, Wwt, Wwt, Wwt, Wwt, Wwt, Gll^Fdw, Gd^Fetd, Cv^Edb, Cv^Edb, Cv^Edb, Cv^Edb, Cv^Edb, Gs, Gs^Ecf, Gll^Fdw, Gll^Fdw, Gll^Fdw, Gs^Ecf, Gs, Gll^Fdw, Gd^Fts, Gd^Fts, Gd^Fts, Gd^Fts, Gd^Fts, Gd^Fts, Rd, Rd^Edt, Gd^Fetd, Gll^Ecf, Co, 3 Ko, Co, Gd^Ecf, Rd^Ecf, Rd^Edt, Rd^Edt, Rd
Gs^Fms, Gg, Gs^Fms, Wwt, Wwt, Wwt, Wwt, Wwt, Wwt, Wwt, Wwt, Wwf, Wwf, Wwt, Wwt, Wwt, Wwt^Bsb|, Wwf, Wwf, Wwf, Wwf, Gd^Fetd, Wwt, Gll^Fdw, Wwt, Gd^Fetd, Gll^Fdw, Gll^Fdw, Gd^Fts, Gd^Fts, Gd^Vo, Gd^Fts, Gd^Fts, Gd^Fts, Gll^Fdw, Gd^Edt, Rd^Edt, Gd^Fetd, Rd^Ecf, Co, Gd^Edt, Gd^Fetd, Gd^Fetd, Rd^Edt, Rd^Edt, Rd^Edt
Gs^Fms, Gs^Fms, Gs^Fms, Gs^Fms, Gs^Fms, Wwt, Gs^Fms, Wwf, Wwf, Wwf, Wwf, Wwt, Wwf, Wwf, Ww^Ewf, Ww^Ewf, Wwt^Bsb|, Wwf, Ww^Ewf, Wwf, Ww^Vm, Wwt, Ww^Ewf, Wwt, Ww^Ewf, Wwt, Ww^Ewf, Gd^Fts, Gd^Fts, Gd^Fts, Gd^Fts, Gd^Fts, Gd^Fts, Gd^Fts, Gd^Fts, Gll^Fdw, Gd^Fetd, Gll^Edt, Gd^Fetd, Re, Rd^Ecf, Gll^Edt, Gll^Edt, Rd^Ecf, Rd^Edt, Rd^Edt
Gs^Fms, Gs^Fms, Gs^Fms, Gs^Fms, Gs^Fms, Gs^Fms, Gs^Fms, Gs^Fms, Gs^Fms, Gs^Fms, Gs^Fms, Wwt, Gs^Fms, Wwt, Wwt, Ww^Ewf, Wwt^Bsb|, Ww^Ewf, Wwt, Ww^Ewf, Ww^Ewf, Ww^Ewf, Ww^Ewf, Ww^Ewf, Wwt, Ww^Ewf, Wwf, Wwf, Wwf, Gd^Fts, Sm^Edt, Sm^Edt, Sm^Edt, Gd^Fts, Gd^Fts, Gd^Fts, Gll^Fdw, Gll^Fdw, Re, Re, Gd^Fetd, Gll^Fdw, Rd^Ecf, Gd^Fetd, Rd^Edt, Rd
Gs^Fms, Gs^Fms, Gg, Gs^Fms, Gg, Gs^Fms, Gg, Gs^Fms, Gs^Fms, Gs^Fms, Gs^Fms, Gs^Fms, Gg, Gs^Fms, Gg, Gs, Re, Wwt, Gs^Fms, Wwt, Gs, Wwt, Wwt, Wwt, Wwt, Ww^Ewf, Ww^Ewf, Ww^Ewf, Wwt, Wwt^Edt, Sm^Edt, Sm^Edt, Sm^Edt, Sm^Edt, Sm^Edt, Gd^Fts, Gd^Fts, Gll^Fdw, Re, Rd^Ecf, Gll^Fdw, Gll^Edt, Gd^Fetd, Gll^Edt, Rd, Rd
Gs^Fms, Gs^Fms, Gs^Fms, Gg, Gs^Fms, Gs^Fms, Gs^Fms, Gs^Fms, Gs^Fms, Gs^Fms, Re, Re, Re, Re, Re, Re, Re, Gs, Gs^Fms, Gs^Fms, Gs^Fms, Gs, Gs, Gs, Gs, Wwt, Wwt, Wwt, Ww^Edt, Wwt^Edt, Wwt^Edt, Sm^Edt, Sm^Edt, Sm^Edt, Sm^Edt, Sm^Edt, Gd^Fts, Gll^Fdw, Re, Gd^Fetd, Gd^Fts, Gd^Fts, Gd^Fts, Gd^Fts, Gd^Fts, Rd
Gs^Fms, Gs^Fms, Gg, Gs^Fms, Gs^Fms, Gs^Fms, Gs^Fms, Gs^Fms, Re, Re, Gs^Fms, Gs^Fms, Gs^Fms, Gg, Gs^Fms, Gs^Fms, Re, Gs^Efm, Gs^Fms, Gs^Fms, Gs^Fms, Gs, Gs^Fms, Gs^Fms, Gs^Fms, Wwf, Ww^Ewf, Wwt, Ww^Ewf, Wwt^Edt, Ww^Ewf, Wwt^Edt, Wwt^Edt, Sm^Edt, Sm^Edt, Sm^Edt, Gd^Fts, Gd^Vo, Re, Re, Re, Gd^Fts, Cud, Gd^Fts, Gd^Fts, Gd^Fts
Gs^Fms, Gg, Gs^Fms, Gs^Fms, Gs^Fms, Gg^Ve, Re, Re, Gs^Fms, Gs^Fms, Gs^Fms, Gs^Fms, Gs^Fms, Gs^Efm, Gs^Efm, Gg^Ve, Re, Gs^Fms, Gs^Fms, Gs^Fms, Gg^Ve, Gg^Fet, Gs^Fms, Gs^Fms, Gs^Fms, Gs^Fms, Wwt, Ww^Ewf, Ww^Ewf, Ww^Ewf, Wwrt, Wwt, Wwt, Ww^Ewf, Wwt, Gs^Fds, Re, Re, Gd^Fts, Gd^Fts, Gll^Fp, Cud, 2 Kud, Cud, Gd^Vo, Gd^Fts
Gs^Fms, Gs^Fms, Gs^Fms, Gs^Fms, Gs^Fms, Re, Gs^Fms, Gs^Fms, Gs^Fms, Gg^Fet, Gs^Fms, Gs^Fms, Gs^Fms, Gs^Fms, Gg^Fet, Gs^Efm, Re, Gs^Fms, Re, Re, Gs^Fms, Gs^Fms, Gs^Fms, Gs^Fms, Gs^Fms, Gs, Gs, Wwt, Wwt^Es, Wwrt, Wwt^Es, Wwrt, Wwt, Wwrt, Wwt^Bw/r, Re, Gs^Fds, Gd^Fts, Gs^Fds, Gd^Fts, Gll^Fp, Cud, Cud, Cud, Gll^Fp, Gs
Gs^Fms, Gs^Fms, Gs^Fms, Gs^Fms, Gs^Fms, Re, Gs^Fms, Gs^Fms, Gs^Fms, Gs^Fms, Gs^Fms, Gs^Fms, Gs^Fms, Gs^Fms, Gs^Fms, Gs^Fms, Re, Re, Gs^Fms, Gs^Fms, Gg, Gs^Fms, Gs^Fms, Gs^Fms, Gg^Fet, Gs^Fms, Gs^Fms, Wwt, Ww^Vm, Wwt^Es, Wwrt, Wwrt, Wwt^Bw/r, Wwt^Bw/r, Wwt^Es, Gs^Fds, Gs^Fds, Gs^Fds, Gs^Fds, Gg^Fet, Gll^Fp, Gll^Fp, Gll^Fp, Gll^Fp, Gll^Fp, Gs
Gs^Fms, Gs^Fms, Gs^Fms, Gs^Fms, Gg^Fet, Re, Gs^Fms, Gs^Fms, Gg^Ve, Gs^Fms, Gs^Fms, Gs^Fms, Gs^Fms, Gs^Fms, Gs^Fms, Gs^Fms, Re, Gs^Fms, Gs^Fms, Gg, Gs, Gg, Gs^Fms, Gs, Gs^Fms, Gs, Gg, Gs^Fms, Wwt^Es, Wwt^Es, Ww^Bw/r, Wwrt^Bw/r, Wwrt, Wwt^Es, Wwrt, Wwt^Es, Wwt^Es, Gs^Fds, Gs^Fds, Gs^Fds, Gs^Fds, Gll^Fp, Gll^Fp, Gll^Fp, Gll^Fp, Gs
Gs^Fms, Gs^Fms, Gs^Fms, Gs^Fms, Gg, Re, Gs^Fms, Gs^Fms, Re, Gs^Fms, Gs^Fms, Gg, Gs^Fms, Gs^Fms, Gs^Fms, Gg^Ve, Re, Gs^Fms, Gs^Fms, Gs^Fms, Gs, Gs, Gs^Edb, Gs^Fms, Gs^Fms, Gs, Gs^Fms, Gs, Re, Ww^Bw/r, Ww^Ewf, Ww^Ewf, Ww^Ewf, Wwrt, Wwt^Es, Wwt^Es, Ww^Vm, Wwt^Es, Wwt^Es, Wwt, Wwt, Gs, Gd^Vo, Gll^Fp, Gs, Gs
Gs^Fms, Gs^Fms, Gs^Fms, Gs^Fms, Re, Re, Re, Gs^Fms, Re, Gs^Fms, Gs^Fms, Gs^Fms, Gs^Fms, Gs^Fms, Gg, Gg, Re, Gs^Fms, Gs, Gs, Gg^Fet, Gs, Gs, Gs^Fms, Gs^Fms, Gg^Ve, Re, Re, Gs^Fms, Gs, Gs, Wwt, Wwt, Wwt^Es, Wwt^Es, Wwt^Es, Wwrt, Wwt, Wwt^Es, Wwt, Ww^Ewf, Ww^Ewf, Ww^Ewf, Ww^Ewf, Ww^Ewf, Gs
Gs^Fms, Gs^Fms, Gs^Fms, Gg^Ve, Gg, Gg, Gs^Fms, Re, Re, Gs^Fms, Gg, Gg, Gs^Fms, Gs^Fms, Gs^Fms, Gs^Fms, Re, Gs^Fms, Gs^Fms, Gs, Gs^Edb, Gs, Gs^Fms, Gs^Fms, Re, Re, Gs^Fms, Gs^Efm, Gs^Efm, Gs^Fms, Gs^Fms, Gs, Gs, Wwt, Wwt, Wwrt, Ss, Wwt, Ss, Wwrt, Wwrt, Ww^Ewf, Ww^Ewf, Ww^Ewf, Ww^Ewf, Ww^Ewf
Gs^Fms, Gs^Fms, Gs^Fms, Gs^Fms, Gs^Fms, Gs^Fms, Gs^Fms, Gs^Fms, Re, Gs^Fms, Gs^Fms, Gs^Fms, Gg, Gs^Fms, Gs^Fms, Gs^Fms, Re, Gs^Fms, Gs^Fms, Gs^Fms, Gs^Fms, Gs^Fms, Re, Re, Gs^Fms, Gs, Gg^Fet, Gs^Fms, Gs^Fms, Gs^Fms, Gs, Gs, Gs^Efm, Gs^Efm, Gs, Ss, Ss, Ss, Ss, Ss, Ss, Wwrt, Wwt, Wwrt, Wwrt, Wwt
Gs^Fms, Gs^Fms, Gg, Gs^Fms, Gs^Fms, Gs^Fms, Gs^Fms, Gs^Fms, Re, Gg^Ve, Gs^Fms, Gs^Fms, Gs^Fms, Gs^Fms, Gs, Gs^Fms, Re, Gs^Fms, Re, Gs^Fms, Gg^Ve, Re, Gg, Re, Re, Gs^Fms, Gs, Gs^Fms, Gs^Fms, Gs^Fms, Gs^Fms, Gs^Fms, Gs, Gs^Efm, Gs^Efm, Gs, Gs^Fms, Ss, Ss, Ss, Ss, Ww^Ewf, Ww^Ewf, Ww^Ewf, Wwt, Wwt
Gs^Fms, Gs^Fms, Gs^Fms, Gs^Fms, Gs^Fms, Gs^Fms, Gs^Fms, Gg^Fet, Re, Gs^Fms, Gs^Fms, Gs^Fms, Gg, Gg, Gs^Fms, Gs, Re, Re, Gs^Fms, Re, Re, Re, Gs^Fms, Gs^Fms, Gs^Fms, Re, Re, Gs^Fms, Gs^Fms, Gs^Efm, Gs^Efm, Gs^Fms, Gs^Fms, Gg^Fet, Gs^Fms, Gs^Fms, Gs^Fms, Gs^Fms, Ss, Ss, Ss, Ss, Ss, Wwt, Gs, Wwt
Gs^Fms, Gs^Fms, Gg, Gs^Fms, Gs^Fms, Gs^Fms, Gs^Fms, Gs^Fms, Re, Gs^Fms, Gg, Gg, Gs^Fms, Gs^Fms, Gs^Fms, Gs, Re, Gs, Gs^Fms, Gs^Fms, Gs^Fms, Gs^Fms, Gs^Fms, Gs^Fms, Gs^Fms, Gs^Fms, Gs^Fms, Re, Gg^Ve, Gs^Fms, Gs^Fms, Gs^Fms, Gs^Edb, Gs^Fms, Gs^Fms, Gs^Fms, Gs, Ss, Ss, Ss, Ss, Ss, Gs^Fms, Gs^Fms, Gs^Fms, Gs
Gs^Fms, Gs^Fms, Gs^Fms, Gs^Fms, Gs^Fms, Gg, Gs^Fms, Gs^Fms, Re, Gs^Fms, Gs^Fms, Gg, Gs^Fms, Gs^Fms, Gs^Fms, Re, Gs^Fms, Gs^Fms, Gs^Fms, Gs^Fms, Gs^Fms, Gs^Fms, Gs^Fms, Gg, Gs^Fms, Gs^Fms, Gs^Fms, Re, Re, Re, Re, Gs^Fms, Gs^Fms, Gs^Fms, Gs^Fms, Gs, Gs^Fms, Gs^Fms, Gs^Fms, Gs, Gs^Fms, Gs^Fms, Gs^Fms, Gs^Fms, Gs^Fms, Gs
Gs^Fms, Gs^Fms, Gs^Fms, Gs^Fms, Gs^Fms, Gg, Gs^Fms, Gs^Fms, Re, Gs^Fms, Gs^Fms, Gs^Fms, Gs^Fms, Gs^Fms, Re, Re, Re, Gs^Fms, Gs^Fms, Gs^Fms, Gg, Gs^Fms, Gs^Fms, Gs^Fms, Gs^Fms, Gs, Gs^Fms, Gs^Fms, Gs^Fms, Gs^Fms, Gs^Fms, Re, Re, Gs^Fms, Gs^Fms, Gs^Fms, Gs^Fms, Gs, Gs^Fms, Gg, Gs^Fms, Gs^Fms, Gs^Fms, Gs^Fms, Gs^Fms, Gs
Gs^Fms, Gs^Fms, Gs^Fms, Gs^Fms, Gs^Fms, Gs^Fms, Gs^Fms, Gg^Ve, Re, Re, Re, Gs^Fms, Re, Re, Gs^Fms, Gg^Ve, Re, Gs^Fms, Gs^Fms, Gs, Gg, Gg, Gs^Fms, Gs^Fms, Gs^Fms, Gg^Fet, Gs^Fms, Gs^Fms, Gs^Fms, Gs^Fms, Gs^Fms, Gs^Fms, Re, Re, Re, Gs^Fms, Gs^Fms, Gs, Gg, Gs^Fms, Gs^Fms, Gs^Fms, Gs^Fms, Gs^Fms, Gs^Fms, Gs
Gs^Fms, Gs^Fms, Gs^Fms, Gs^Fms, Gs^Fms, Gs^Fms, Gs^Fms, Gs^Fms, Re, Gs^Fms, Gs^Fms, Re, Gs^Fms, Gg, Gs^Fms, Gs^Fms, Gs^Fms, Re, Gg^Ve, Gs^Fms, Gs^Fms, Gs, Gs, Gs^Fms, Gs^Fms, Gs^Fms, Gs^Fms, Gs^Fms, Re, Re, Re, Re, Gs^Fms, Gs^Fms, Gs^Fms, Re, Re, Re, Re, Gg, Gs^Fms, Gs^Fms, Gs^Fms, Gs^Fms, Gs^Fms, Gs
Gs^Fms, Gs^Fms, Gs^Fms, Gs^Fms, Gg^Ve, Gs^Fms, Gs^Fms, Gs^Fms, Re, Gs^Fms, Gs^Fms, Gs^Fms, Gs^Fms, Gg, Gs^Fms, Gg, Gs^Fms, Re, Re, Gg, Gs^Fms, Gs, Gs^Fms, Gs^Edb, Gs^Fms, Gs^Fms, Re, Re, Gg, Gg^Ve, Gs^Fms, Gs^Fms, Gs^Fms, Gs^Fms, Gs^Fms, Gs^Fms, Gs, Gs, Gs, Re, Re, Gs^Fms, Gs^Fms, Gs^Fms, Gs, Gs
Gs^Fms, Gs^Fms, Gg^Fet, Gs^Fms, Gg, Gs^Fms, Gs^Fms, Gs^Fms, Re, Gs^Fms, Gg^Fet, Gs^Fms, Gs^Fms, Gs^Fms, Gs^Fms, Gs^Fms, Gs^Fms, Gs^Fms, Gs^Fms, Re, Gs^Fms, Gs^Fms, Gs^Fms, Gs^Fms, Re, Re, Gs^Fms, Gg, Gs^Fms, Gs^Fms, Gs^Fms, Gs^Fms, Gs^Fms, Gs^Fms, Gs^Fms, Gs^Fms, Gs^Fms, Gs^Fms, Gs^Fds, Gs^Fds, Gs^Fds, Re, Gg^Ve, Gs, Gs^Fms, Gs
Gs^Fms, Gs^Fms, Gs^Fms, Gg, Gg, Gs^Fms, Gs^Fms, Gs^Fms, Re, Gs^Fms, Gs^Fms, Gs^Fms, Gg, Gg, Gs^Fms, Gs^Fms, Gs^Fms, Gs^Fms, Gs^Fms, Re, Re, Gs^Fms, Re, Re, Gs^Fms, Gs^Fms, Gs^Edb, Gs^Fms, Gs^Fms, Gs^Fms, Gs^Fms, Gs^Fms, Gs, Gs^Fms, Gs^Fms, Gs^Fms, Gs^Fms, Gs^Fds, Gs^Fds, Gs^Fds, Gs^Fds, Gs^Fds, Gs, Gs, Gs^Fms, Gs
Gs^Fms, Gs^Fms, Gs^Fms, Gs^Fms, Gg, Gs^Fms, Gs^Fms, Gs^Fms, Re, Gs^Fms, Gs^Fms, Gs^Fms, Gs^Fms, Gs^Fms, Gs^Fms, Gs^Fms, Gs^Fms, Gg^Fet, Gs^Fms, Gs^Fms, Gs^Fms, Re, Gs^Fms, Gs^Fms, Gs^Fms, Gs^Fms, Gs^Fms, Gs^Fms, Gs^Fms, Gs^Fms, Gs, Gs, Wwrt, Gs, Wwt, Gs^Fms, Gg, Gs^Fms, Gs^Fds, Gs^Fds, Gs^Fds, Gs^Fds, Gs^Fms, Gs^Fms, Gs^Fms, Gs
Gs^Fms, Gs^Fms, Gs^Fms, Gg, Gs^Fms, Gs^Fms, Gs^Fms, Gs^Fms, Gg^Ve, Gs^Fms, Gs^Fms, Gg, Gs^Fms, Gg, Gs^Fms, Gs^Fms, Gs^Fms, Gs^Fms, Gs^Fms, Gs^Fms, Gs^Fms, Re, Gs^Fms, Gs^Fms, Gs^Fms, Gs^Fms, Gs^Fms, Gs^Fms, Gs^Fms, Gs^Fms, Gs^Fms, Wwrt, Wwrt, Ww^Vm, Ww^Ewf, Wwt, Gs, Gs^Fds, Gs^Fms, Gs^Fms, Gg^Fet, Gs^Fms, Gs^Fms, Gs^Fms, Gs^Fms, Gs
Gs^Fms, Gs^Fms, Gs^Fms, Gs^Fms, Gs^Fms, Gs^Fms, Gs^Fms, Gs^Fms, Gs^Fms, Gs^Fms, Gs^Fms, Gs^Fms, Gs^Fms, Gg, Gs^Fms, Gs^Fms, Cv, Gs^Fms, Gs^Fms, Gs^Fms, Gs^Fms, Re, Gg, Gs, Gg, Gs^Fms, Gs^Fms, Gs^Fms, Gg^Fet, Gs^Fms, Gs^Fms, Wwrt, Wwt, Wwt, Wwt, Wwt, Gs, Gs^Fms, Gs^Fms, Gs^Fms, Gs^Fms, Gs^Fms, Gs^Fms, Gs^Fms, Gs^Fms, Gs
Gs^Fms, Gs^Fms, Gs^Fms, Gs^Fms, Gs^Fms, Gs^Fms, Gs^Fms, Gs^Fms, Gs^Fms, Gs^Fms, Gs^Fms, Gs^Fms, Gs^Fms, Gs^Fms, Gs^Fms, Cv, 1 Kv, Cv, Gs, Gs^Fms, Re, Re, Gs^Fms, Gg^Ve, Gs, Gg, Gs^Fms, Gs^Fms, Gs^Fms, Gs^Fms, Gs^Fms, Gs^Fms, Ww^Ewf, Ww^Ewf, Ww^Ewf, Wwt, Gs, Gs^Fms, Gs^Fms, Gs^Fms, Gs^Fms, Gs^Fms, Gs^Fms, Gg^Fet, Gs^Fms, Gs
Gs^Fms, Gs^Fms, Gs^Fms, Gs^Fms, Gg, Gg, Gs^Fms, Gs^Fms, Gs^Fms, Gs^Fms, Gs^Fms, Gs^Fms, Gs^Fms, Gs^Fms, Gs^Fms, Cv, Cv, Cv, Re, Re, Gs^Fms, Gs^Fms, Gs^Fms, Gs^Fms, Gs^Fms, Gs^Fms, Gg, Gs^Fms, Gs^Fms, Gs^Fms, Gs^Fms, Gs^Fms, Gs, Ww^Ewf, Gs^Fms, Gs^Fms, Gs^Fms, Gs^Fms, Gs^Fms, Gs^Fms, Gs^Fms, Gs^Fms, Gs^Fms, Gs^Fms, Gs^Fms, Gs
Gs^Fms, Gs^Fms, Gs^Fms, Gs^Fms, Gs^Fms, Gg, Gs^Fms, Gs^Fms, Gs^Fms, Gs^Fms, Gg, Gg, Gg, Gs^Fms, Gs^Fms, Gs^Fms, Gs^Fms, Gs^Fms, Gs^Fms, Gs^Fms, Gs^Fms, Gs^Fms, Gs^Fms, Gg, Gs^Fms, Gs^Fms, Gs^Fms, Gs^Fms, Gs^Fms, Gs^Fms, Gs^Fms, Gs^Fms, Gs^Fms, Gs^Fms, Gs^Fms, Gs^Fms, Gs^Fms, Gs^Fms, Gg^Ve, Gs^Fms, Gs^Fms, Gs^Fms, Gs^Fms, Gs^Fms, Gs^Fms, Gs
Gs^Fms, Gs^Fms, Gs^Fms, Gs^Fms, Gs^Fms, Gs^Fms, Gs^Fms, Gs^Fms, Gs^Fms, Gs^Fms, Gs^Fms, Gg, Gs^Fms, Gs^Fms, Gs^Fms, Gg, Gs^Fms, Gs^Fms, Gs^Fms, Gs^Fms, Gg^Fet, Gs^Fms, Gs^Fms, Gs^Fms, Gs^Fms, Gs^Fms, Gs^Fms, Gs^Fms, Gs^Fms, Gs^Fms, Gs^Fms, Gs^Fms, Gs^Fms, Gs^Fms, Gs^Fms, Gs^Fms, Gs^Fms, Gs^Fms, Gs, Gs, Gs^Fms, Gg^Fet, Gs^Fms, Gs^Fms, Gs^Fms, Gs
Gs^Fms, Gs^Fms, Gs^Fms, Gs^Fms, Gs^Fms, Gs^Fms, Gs^Fms, Gs^Fms, Gs^Fms, Gs^Fms, Gs^Fms, Gs^Fms, Gs^Fms, Gs^Fms, Gs^Fms, Gs^Fms, Gs^Fms, Gs^Fms, Gs^Fms, Gs^Fms, Gs^Fms, Gs^Fms, Gs, Gs^Fms, Gs^Fms, Gs^Fms, Gs^Fms, Gs^Fms, Gs, Gs^Fms, Gs, Gs, Gs, Gs^Fms, Gs^Fms, Gs^Fms, Gs^Fms, Gs^Fms, Gs, Gs, Gs, Gs^Fms, Gs^Fms, Gs^Fms, Gs, Gs
