Ww, Hh, Gs^Fms, Hh, Gs^Fms, Gs^Fds, Gs^Fds, Gs^Fds, Gs^Fds, Gs^Fds, Mm^Xm, Ms^Xm, Ms^Xm, Mm^Xm, Mm^Xm, Mm^Xm, Mm^Xm, Gs, Mm^Xm, Mm^Xm, Mm, Mm, Mm, Mm, Mm, Gs, Gg, Rp, Ww, Gg, Ss, Gs, Gd^Fts, Hhd, Hhd, Hhd, Hhd, Md, Md, Md, Hhd, Rd, Hhd, Rd, Re, Rd
Ww, Ww, Ww, Mm, Mm, Gs^Fms, Gs^Fms, Gs^Fms, Gs^Fms, Hh, Hh, Mm^Xm, Mm^Xm, Mm^Xm, Mm, Mm^Xm, Mm, Mm^Xm, Mm, Mm, Mm, Mm, Mm, Mm, Mm, Mm, Gg, Rp, Gg, Ww, Gd^Fts, Gd^Fts, Gd^Fts, Rd^Edt, Rd^Edt, Hhd, Hhd, Md, Md, Md, Md, Md, Md, Hhd, Re, Rd
Gg, Ww, Ww, Ww, Ww, Ww, Ww, Gs^Fms, Gs^Fms, Gs^Fms, Gs^Fms, Gs^Fms, Gs^Fms, Hh, Hh, Hh, Hh, Mm, Gs^Fms, Hh, Hh, Hh, Hh, Hh, Rp, Rp, Rp, Rp, Ww, Ww, Gd^Fts, Gd^Fts, Gd^Fts, Gd^Fts, Rd, Rd^Edt, Re, Hhd, Re^Vct, Hhd, Hhd, Md, Re, Re, Rd^Edt, Rd
Hh, Gg, Gs^Fms, Ww, Ww, Ww, Ww, Ww, Ww, Ww, Ww, Gs^Fms, Gs^Fms, Gs^Fms, Gs^Fms, Gs^Fms, Gs^Fms, Gs^Fms, Rp, Rp, Rp, Rp, Rp, Rp, Gg, Gg, Gll^Fdw, Rp, Ww^Bw\, Gd^Fts, Gd^Vo, Gd^Fts, Gd^Fts, Gd^Fts, Gll^Fdw, Gd^Edt, Rd^Edt, Re, Re, Re, Gd^Edt, Re, Hhd, Hhd, Hhd, Rd^Edt
Hh, Hh, Hh, Gs^Fms, Gs^Fms, Gg, Gs^Fms, Ww, Ww, Ww, Ww, Ww, Ww, Wwf, Ww, Wwf, Ww, Gg, Rp, Gg, Ww^Vm, Gg, Gg, Gg, Wwf, Gs, Ww, Ww, Gd^Fts, Rb, Rb, Gd^Fts, Hhd, Gd^Fts, Gd^Fts, Gll^Fdw, Gd^Fetd, Gll^Edt, Re, Re, Re, Hhd, Md, Md, Md, Hhd
Mm, Mm, Mm, Hh, Gs^Fms, Gs^Fms, Hh, Gs^Fms, Gs^Fms, Gs^Fms, Gs^Fms, Ww, Wwf, Ww, Gg, Ww, Ww^Bw/, Ww^Bw/, Ww, Ww, Ww^Ewf, Ww, Ww, Ww, Ww, Ww, Ww, Gs, Gs, Gd^Fts, Gll^Fdw, Rb, Md, Hhd, Gd^Fts, Gd^Fts, Gll^Fdw, Re, Re, Re, Re, Gll^Fdw, Md, Md, Md, Rd
Mm, Mm, Mm, Hh, Hh, Gs^Fms, Gg, Hh, Gs^Fms, Gs^Fms, Gs^Fms, Gs^Fms, Gs^Vh, Gs^Fms, Rb, Rb, Gs^Fms, Ww, Wwf, Ww, Gs, Ww, Wwf, Ww, Ww, Ww, Ww, Wwf, Gs, Gs, Gd^Vo, Rb, Rb, Hhd, 3 Ko, Gd^Fts, Gd^Fts, Gll^Fdw, Re, Rd^Ecf, Re, Gll^Edt, Re^Vct, Md, Md, Rd
Mm, Mm, Mm, Hh, Hh, Gs^Fms, Gs^Fms, Gs^Fms, Gs^Fms, Gs^Fms, Rb, Rb, Rb, Rb, Rb, Gs^Fms, Gs^Fms, Gs, Gs^Fms, Gs^Fms, Gs^Fms, Gs, Gs, Gs, Gs, Ww, Ww, Ww, Wwf, Ss, Ss, Sm^Edt, Rb, Co, Co, Co, Rb, Gll^Fdw, Re, Gd^Fetd, Re, Re, Re^Vct, Re, Sm, Sm
Mm, Mm, Hh, Mm, Hh, Gs^Fms, Gs^Fms, Gs^Fms, Rb, Rb, Hh, Gs^Fms, Gs^Fms, Gg, Gs^Fms, Rb, Rb, Gs^Efm, Gg, Gs^Fms, Gs^Fms, Gs, Gs^Fms, Gs^Fms, Gs^Fms, Wwf, Wwf, Ww, Wwf, Wwf, Wwg, Sm, Sm, Rb^Edt, Rb, Rb, Re, Re, Re^Edt, Re, Re, Re, Sm, Ss, Ss, Ss
Mm, Mm, Hh, Hh, Gs^Fms, Gs^Vc, Rb, Rb, Hh, Hh, Mm, Mm, Hh, Hh, Rb, Gg, Rb, Gg, Gs^Fms, Gg, Gg, Gg^Fet, Hh, Hh, Gs^Fms, Gs^Fms, Gg, Wwf, Gg, Ww, Ww, Wwg, Sm, Rb, Gll^Edb, Gll^Fdw, Re, Re^Edt, Gd^Fts, Gd^Fts, Gll^Fdw, Re, Sm, Ss, Sm, Sm
Mm, Hh, Hh, Gs^Fms, Gs^Fms, Rb, Gs^Fms, Gs^Fms, Hh, Mm, Mm, Hh, Hh, Rb, Gg^Fet, Rb, Gs^Fms, Gs^Fms, Gs^Fms, Rb, Gg, Gs^Fms, Gg, Mm, Gg, Gs, Gs, Gg, Gg, Ww^Es, Ww, Ww, Gg^Em, Rb, Re, Re, Gll^Fdw, Gll^Fdw, Cud, Cud, Cud, Rb, Rb, Rb, Rb, Rb
Hh, Hh, Gs^Fms, Gs^Fms, Gs^Fms, Rb, Gs^Fms, Hh, Mm, Mm, Gs^Fms, Hh, Gs^Fms, Rb, Gs^Fms, Gs^Fms, Gs^Fds, Gs^Fds, Hh, Gs^Fms, Gg, Gg, Gs^Fms, Gg, Gg^Fet, Gs^Fms, Gg, Gg, Ww^Vm, Ww, Wwf^Es, Gg, Re, Re, Gll^Es, Gll^Fdw, Gll^Fdw, Gll^Fdw, Gll^Edt, 4 Kud, Gll^Fdw, Gll^Edt, Gll^Fdw, Sm, Ss, Ss
Gs^Fms, Gs^Fms, Gs^Fms, Gs^Fms, Gg^Fet, Rb, Gs^Fms, Gs^Fms, Hh^Vhh, Gs^Fms, Gs^Fms, Gs^Fms, Gs^Fms, Rb, Rb, Gs^Fms, Hh, Mm, Hh, Hh, Gs, Gg^Ve, Gs^Fms, Gs, Hh, Gs, Gg, Gs^Fms, Wwf^Es, Wwf, Ww^Bw/r, Wwf^Bw/, Wwf^Es, Gg, Gg, Gll^Edb, Gll, Gll^Fdw, Gll, Gll^Fdw, Gll^Fdw, Gll^Fdw, Gll^Fdw, Sm, Sm, Ss
Gs^Fms, Gs^Fms, Gs^Fms, Gs^Fms, Gg, Rb, Gs^Fms, Gs^Fms, Gg, Gg, Gs^Fms, Gg, Gs^Fms, Gs^Fms, Rb, Hh, Gg^Ve, Hh, Gs^Fms, Hh, Gs, Gs^Fds, Gs^Edb, Mm, Rb, Rb, Rb, Gs, Rb, Wwf^Bw/, Wwf^Es, Wwf, Ww^Es, Ww, Ww, Gg^Em, Ww^Vm, Gg, Gg, Gll, Gll, Gll, Gd^Vo, Gll^Fdw, Ww, Ww
Gs^Fms, Gs^Fms, Gs^Fms, Gs^Fms, Rb, Rb, Rb, Gs^Fms, Rb, Gs^Fms, Gs^Fms, Gs^Fms, Gg, Gs^Fms, Gs^Fms, Gg, Rb, Gs^Fms, Gs, Gs, Gg^Fet, Gs, Gs^Fms, Hh, Rb, Gg^Ve, Gs^Fms, Rb, Gs^Fms, Gs, Gs^Fds, Ww, Ww^Ewf, Ww, Wwf, Wwf, Ww^Es, Ww, Ww, Gg, Gg^Em, Gg, Ww, Ww, Ww, Ww
Rb, Gs^Fms, Rb, Gs^Vl, Rb, Gg, Gs^Fms, Rb, Rb, Gg, Gg, Gg, Gs^Fms, Gg, Gg, Gs^Fms, Rb, Gs^Fms, Gs^Fms, Gs^Fds, Gs^Edb, Gs^Fds, Gg, Gs^Fms, Rb, Gs^Fms, Hh, Gs^Efm, Gs^Efm, Gg, Gs^Fms, Gs, Gs, Wwf, Wwf, Ww, Ww, Ww, Ww, Ww, Ww, Ww, Ww, Ww, Wo, Wo
Gs^Fms, Rb, Gs^Fms, Rb, Gs^Fms, Gs^Fms, Gs^Fms, Gs^Fms, Gs^Fds, Gs^Fms, Gs^Fms, Gs^Fms, Gg, Gs^Fms, Gs^Fms, Gg, Rb, Gs^Fms, Gg, Gg, Cv, Gs^Fms, Rb, Rb, Gs^Fms, Hh, Gg^Fet, Gs^Fms, Gg, Hh, Gs, Gs, Hh, Gs^Efm, Gs, Ss, Ss, Ss, Ss, Ww, Ww, Ww, Ww, Wo, Wo, Wo
Gg, Gs^Fms, Gs^Fds, Gs^Fms, Gs^Fms, Gs^Fms, Hh, Gs^Fms, Gs^Fds, Gs^Fds, Gs^Fms, Hh, Hh, Gs^Fms, Gs^Fds, Gs^Fms, Rb, Gg, Rb, Cv, 2 Kv, Cv, Gg, Rb, Rb, Gs^Fms, Gs, Gg, Gs^Fms, Mm, Gg, Hh, Gs, Gs^Efm, Gs^Efm, Gs, Gs^Fds, Ss, Ss, Ss, Ss, Ww, Ww, Wo, Wo, Wo
Gs^Fds, Gs^Fms, Hh, Gs^Fms, Gs^Fms, Hh, Gs^Fms, Gg^Fet, Gs^Fds, Hh, Gs^Fms, Hh, Gs^Fds, Gs^Fds, Gs^Fds, Gs, Rb, Rb, Gs^Fms, Cv, Cv, Cv, Gs^Fms, Gs^Fms, Gg, Rb, Rb, Gs^Fms, Gs^Fms, Gs^Efm, Gs^Efm, Gs^Fms, Gg, Gg^Fet, Gs^Fms, Gs^Fms, Gs^Fms, Gs^Fms, Ss, Ss, Ss, Ww, Ww, Ww, Ww, Wo
Gs^Fms, Hh, Mm, Gs^Fms, Gs^Fms, Gs^Fms, Gs^Fms, Gs^Fms, Gs^Fds, Gs^Fms, Gg, Gs^Fds, Gs^Fms, Gs^Fds, Gs^Fms, Gs, Rb, Gs, Gs^Fms, Gs^Fms, Gs^Fms, Gs^Fms, Gs^Fms, Gs^Fms, Gs^Fms, Gs^Fms, Gs^Fms, Rb, Gg^Ve, Gs^Fms, Gs, Gg, Gs^Edb, Gs^Fms, Gg, Gs^Fms, Gs, Ss, Ss, Ss, Ss, Ss, Gs^Fms, Ww, Ww, Ww
Gs^Fms, Mm, Hh, Hh, Hh, Hh, Gs^Fms, Gs^Fms, Rb, Rb, Gs^Fms, Gg, Rb, Rb, Rb, Rb, Gs^Efm, Gs^Efm, Gs^Fms, Gs^Fms, Gs^Fms, Gs^Fms, Gs^Efm, Gg, Mm, Gs^Efm, Gs^Fms, Rb, Rb, Gs, Gs^Fms, Gs^Fms, Gs^Fms, Gg, Gg, Gs, Gg, Gg, Gs^Fms, Gs, Gs^Fms, Gs^Fms, Hh, Ww, Ww, Gs^Fms
Gs^Fms, Gs^Fms, Gs^Fms, Hh, Gs^Fms, Hh, Gs^Fms, Gs^Fms, Rb, Gs^Fms, Hh, Gs^Fms, Gs^Fms, Gs^Fms, Gg^Efm, Rb, Rb, Gs^Fms, Gs^Fms, Gs^Fms, Gg^Efm, Gs^Fms, Gs^Fms, Hh, Hh, Gs^Fms, Gs^Fms, Gs^Fms, Rb, Gs^Fms, Gs^Fms, Gs^Fms, Gs^Fms, Gs^Fms, Gs^Fms, Gs^Fms, Hh, Gs, Wwf, Gg, Wwf, Gs^Fms, Gs^Fms, Gs^Fms, Ww, Gs^Fms
Gs^Fms, Gs^Fms, Gs^Fms, Gs^Fms, Gs^Fms, Gs^Fms, Gs^Fms, Gg, Rb, Gs^Fds, Hh, Hh, Hh, Gg^Efm, Gs^Fms, Gg^Ve, Rb, Gs^Fms, Gs^Fms, Gs^Efm, Gg, Gg, Gs^Fms, Gs^Fms, Gs^Fms, Gg^Fet, Rb, Gs^Fms, Rb, Gs^Fms, Gs^Fms, Hh, Hh, Gs^Fms, Gs^Fms, Hh, Hh, Wwf, Gg, Wwf, Gs^Fms, Wwf, Ww, Ww, Gs^Fms, Gs^Fms
Gs^Fms, Gs^Fms, Gs^Fms, Gs^Fms, Gs^Fms, Gs^Fms, Rb, Rb, Gs^Fms, Gs^Fds, Hh, Mm, Hh, Gg^Efm, Hh, Hh, Gs^Fms, Rb, Gg, Gs^Fms, Gs^Fms, Gs, Gs^Efm, Gs^Fms, Gs^Fms, Rb, Gs^Fms, Rb, Gs^Fms, Gs^Fms, Hh, Mm, Gs^Fms, Gs^Fms, Gs^Fms, Gs^Fms, Ww, Ww, Gs^Fms, Gg, Gg, Gs^Fms, Gs^Fms, Gs^Fms, Gs^Fms, Gs^Fms
Gs^Fms, Gs^Fms, Gs^Fms, Gs^Fms, Gg, Gg, Rb, Gs^Fms, Gs^Fms, Gs^Fms, Gs^Fms, Hh, Gs^Fds, Gg^Efm, Gs^Fds, Gs^Fds, Gs^Fms, Rb, Rb, Gs^Fms, Gs^Fms, Gs^Efm, Gs^Fms, Gs^Edb, Gs^Fms, Rb, Gs^Fms, Gs^Fms, Gs^Fms, Gs^Fms, Gs^Fms, Hh, Gs^Fms, Gs^Fms, Gs^Fms, Ww, Gs, Gs^Fms, Gs, Gs^Fms, Gg, Gs^Fms, Gs^Fms, Gs^Fms, Rb, Rb
Gs^Fms, Gs^Fms, Gg^Fet, Gs^Fms, Hh, Hh, Hh^Vhh, Rb, Rb, Gs^Fms, Gg^Fet, Gs^Fms, Gg^Efm, Gs^Fms, Gs^Fms, Gs^Fds, Rb, Rb, Gs^Fms, Rb, Gs^Fms, Gs^Fms, Gs^Fms, Gs^Fms, Rb, Rb, Gs^Fms, Gs^Fms, Gs^Fms, Hh, Hh, Gs^Fms, Gs^Fms, Gs^Fms, Gs^Fms, Ww, Ww, Gs^Fms, Gs^Fds, Gg, Gs^Fds, Gs^Fms, Gs^Fms, Rb, Gs^Fms, Gs
Gs^Fms, Gs^Fms, Hh, Hh, Hh, Hh, Gs^Fms, Gs^Fms, Rb, Gs^Fms, Gs^Fms, Hh, Gg^Efm, Gs^Fms, Gs^Fds, Gs^Fds, Rb, Gs^Fms, Gs^Fms, Rb, Rb, Gs^Fms, Rb, Rb, Gs^Fms, Gs^Fms, Gs^Edb, Gs^Fms, Gs^Fms, Hh, Gs^Fms, Gs^Fms, Rb, Gs^Fms, Rb, Rb, Ww, Gs^Fds, Gs^Fds, Gg, Gg, Gs^Vc, Rb, Rb, Gs^Fms, Gs^Fms
Gs^Fms, Gs^Fms, Mm, Mm, Mm, Gs^Fms, Gs^Fms, Gs^Fms, Rb, Gs^Fms, Gs^Fms, Gg^Efm, Gs^Fms, Gs^Fms, Rb, Gs^Fms, Rb, Gg^Fet, Hh, Gs^Fms, Gs^Fms, Rb, Gs^Fms, Gs^Fms, Gs^Fms, Gs^Fms, Gs^Fms, Gs^Fms, Hh, Gs^Fms, Rb, Rb, Wwf, Rb, Ww, Ww, Chw, Gs^Fms, Gs^Fds, Gs^Fds, Rb, Rb, Gs^Fms, Gs^Fms, Gs^Fms, Gs^Fms
Mm, Mm, Mm, Mm, Gs^Fms, Gs^Fms, Rb, Rb, Ce, Rb, Rb, Gs^Fms, Rb, Rb, Gs^Vh, Rb, Gg, Gs^Fds, Mm, Hh, Gs^Fms, Gg, Gs^Fms, Gs^Fms, Gs^Fms, Gs^Fms, Gs^Fms, Gs^Fms, Gs^Fms, Gs^Fms, Rb, Wwf, Ww, Ww^Vm, Ww, Chw, Chr, Gs^Fds, Gs^Fms, Rb, Gg^Fet, Gs^Fms, Gs^Fms, Gs^Fms, Gs^Fms, Gs^Fms
Mm, Mm, Mm, Mm, Gs^Fms, Gs^Fms, Rb, Ce, 1 Ke, Ce, Rb, Rb, Gs^Fms, Gg, Gs^Fms, Gg^Efm, Gg, Mm, Mm, Mm, Gs^Fms, Gg, Gg, Gs^Fds, Gg, Gs^Fms, Gs^Fms, Gs^Fms, Gg^Fet, Gs^Fms, Rb, Ww^Ewl, Ww, Ww^Ewf, Ww, Khw, Rb, Gs^Fms, Rb, Rb, Gs^Fms, Gs^Fms, Gs^Fms, Gs^Fms, Gs^Fms, Gs^Fms
Mm, Mm, Gg, Gg, Rb, Rb, Gg, Ce, Ce, Ce, Gs^Fms, Gs^Fms, Gs^Fms, Gs^Fms, Gs^Fms, Gs^Fms, Gg, Hh, Hh, Mm, Mm, Gs^Fms, Gs^Fms, Gg, Gs^Fds, Gg, Gs^Fms, Gs^Fms, Gs^Fms, Gs^Fms, Gg, Rb, Ww, Ww, Wwf, Wwf, Rb, Rb, Gg, Gg, Gs^Fms, Gs^Fms, Gs^Fms, Gg^Fet, Hh, Hh
Gs^Fms, Gs^Fms, Rb, Rb, Gg, Gg, Ww, Ww, Ww, Ww, Ww, Gs^Fms, Ww, Gs^Fms, Ww, Ww, Ww, Gg^Efm, Gg^Efm, Mm, Mm, Hh, Hh, Gs^Fms, Gs^Fms, Gg, Gg, Gs^Fms, Gs^Fds, Gg, Gs^Vh, Rb, Rb, Ss, Rb, Wwf, Wwf, Gg, Gs^Fms, Gs^Fms, Gs^Fms, Gs^Fms, Hh, Hh, Mm, Mm
Gs^Fms, Gs^Fms, Rb, Gs^Vc, Gg, Gg, Ww, Gs^Fms, Gs^Fms, Gs^Fms, Gg, Ww, Ww^Ewf, Ww, Ww, Gs^Fms, Gs^Fms, Ww, Ww, Hh, Mm, Mm, Hh, Gg, Gs^Fms, Gs^Fms, Gg, Gs^Fms, Gg, Gg, Gs^Fms, Gs^Fms, Gs^Fds, Rb, Gs^Fms, Rb, Ww, Gs^Fms, Ww, Gs^Fms, Gs^Fms, Gs^Fms, Hh, Mm, Mm, Mm
Rb, Rb, Gg, Gg, Ww, Ww, Gs^Fms, Gs^Fms, Gs^Fms, Gs^Fms, Gs^Fms, Ww, Ww, Ww, Mm, Mm, Mm, Gs^Fms, Ww, Hh, Hh, Mm, Mm, Mm, Hh, Gs^Fms, Gs^Fms, Gg, Gs^Fms, Gs^Fms, Gs^Fds, Gs^Fds, Gs^Fds, Gs^Fms, Gs^Fms, Rb, Rb, Ww, Gs, Ww, Hh, Gg^Fet, Mm, Mm, Mm, Mm
Gs^Fms, Gg, Ww, Ww, Gs^Fms, Gs^Fms, Gs^Fms, Gs^Fms, Gs^Fms, Gs^Fms, Gs^Fms, Gs^Fms, Gs^Fms, Mm, Gs^Fms, Mm, Mm, Mm, Mm, Ww, Gs^Fms, Mm, Gs, Hh, Gs^Fms, Gs^Fms, Gs^Fms, Gs^Fms, Gs^Fds, Gs^Fds, Gs^Fds, Gs^Fds, Gs^Fds, Gs^Fds, Gs^Fms, Gs^Fms, Gs^Fms, Rb, Ww, Ww, Mm, Mm, Gs^Fms, Mm, Gs, Hh
